[map]
size=158x90
description=
background=backtex.jpg
dc1=dc1.png
dc2=dc2.png
dc3=dc3.png
dc4=dc4.png
maxplayer=8
lives0=10
lives1=5
lives2=1
type=0
waves=4

[data]
row0=00000000000000000000000000000000000000000000000000000000000000000000000000000000000000000000000000000000000000000000000000000000000000000000000000000000000000
row1=00000000000000000000000000000000000000000000000000000000000000000000000000000000000000000000000000000000000000000000000000000000000000000000000000000000000000
row2=00222222222222222222222222222222222222200222222222222222222222222222222222222200222222222222222222222222222222222222200222222222222222222222222222222222222200
row3=00222222222222222222222222222222222222200222222222222222222222222222222222222200222222222222222222222222222222222222200222222222222222222222222222222222222200
row4=00222222222222222222222222222222222222200222222222222222222222222222222222222200222222222222222222222222222222222222200222222222222222222222222222222222222200
row5=00222111112222222222222222222222222222200222111112222222222222222222222222222200222111112222222222222222222222222222200222111112222222222222222222222222222200
row6=00222111112222222222222222222222222222200222111112222222222222222222222222222200222111112222222222222222222222222222200222111112222222222222222222222222222200
row7=00222111111111122221111111111111111122200222111111111122221111111111111111122200222111111111122221111111111111111122200222111111111122221111111111111111122200
row8=00222111111111122221111111111111111122200222111111111122221111111111111111122200222111111111122221111111111111111122200222111111111122221111111111111111122200
row9=00222111111111122221111111111111111122200222111111111122221111111111111111122200222111111111122221111111111111111122200222111111111122221111111111111111122200
row10=00222111112211122221112222222222211122200222111112211122221112222222222211122200222111112211122221112222222222211122200222111112211122221112222222222211122200
row11=00222111112211122221112222222222211122200222111112211122221112222222222211122200222111112211122221112222222222211122200222111112211122221112222222222211122200
row12=00222222222211122221112222222222211122200222222222211122221112222222222211122200222222222211122221112222222222211122200222222222211122221112222222222211122200
row13=00222222222211122221112222222222211122200222222222211122221112222222222211122200222222222211122221112222222222211122200222222222211122221112222222222211122200
row14=00222222222211122221112222222222211122200222222222211122221112222222222211122200222222222211122221112222222222211122200222222222211122221112222222222211122200
row15=00222222222211122221112222222222211122200222222222211122221112222222222211122200222222222211122221112222222222211122200222222222211122221112222222222211122200
row16=00222111111111111111111111111222211122200222111111111111111111111111222211122200222111111111111111111111111222211122200222111111111111111111111111222211122200
row17=00222111111111111111111111111222211122200222111111111111111111111111222211122200222111111111111111111111111222211122200222111111111111111111111111222211122200
row18=00222111111111111111111111111222211122200222111111111111111111111111222211122200222111111111111111111111111222211122200222111111111111111111111111222211122200
row19=00222111222211122221112222111222211122200222111222211122221112222111222211122200222111222211122221112222111222211122200222111222211122221112222111222211122200
row20=00222111222211122221112222111222211122200222111222211122221112222111222211122200222111222211122221112222111222211122200222111222211122221112222111222211122200
row21=00222111222211122221112222111222211122200222111222211122221112222111222211122200222111222211122221112222111222211122200222111222211122221112222111222211122200
row22=00222111222211122221112222111222211122200222111222211122221112222111222211122200222111222211122221112222111222211122200222111222211122221112222111222211122200
row23=00222111222211122221112222111222211122200222111222211122221112222111222211122200222111222211122221112222111222211122200222111222211122221112222111222211122200
row24=00222111222211122221112222111222211122200222111222211122221112222111222211122200222111222211122221112222111222211122200222111222211122221112222111222211122200
row25=00222111222211122221112222111222211122200222111222211122221112222111222211122200222111222211122221112222111222211122200222111222211122221112222111222211122200
row26=00222111222211122221112222111222211122200222111222211122221112222111222211122200222111222211122221112222111222211122200222111222211122221112222111222211122200
row27=00222111222211122221112222111222211122200222111222211122221112222111222211122200222111222211122221112222111222211122200222111222211122221112222111222211122200
row28=00222111222211122221112222111222211122200222111222211122221112222111222211122200222111222211122221112222111222211122200222111222211122221112222111222211122200
row29=00222111222211122221112222111222211122200222111222211122221112222111222211122200222111222211122221112222111222211122200222111222211122221112222111222211122200
row30=00222111222211122221112222111222211122200222111222211122221112222111222211122200222111222211122221112222111222211122200222111222211122221112222111222211122200
row31=00222111111111122221111111111222211122200222111111111122221111111111222211122200222111111111122221111111111222211122200222111111111122221111111111222211122200
row32=00222111111111122221111111111222211122200222111111111122221111111111222211122200222111111111122221111111111222211122200222111111111122221111111111222211122200
row33=00222111111111122221111111111222211122200222111111111122221111111111222211122200222111111111122221111111111222211122200222111111111122221111111111222211122200
row34=00222222222222222222222222222222211122200222222222222222222222222222222211122200222222222222222222222222222222211122200222222222222222222222222222222211122200
row35=00222222222222222222222222222222211122200222222222222222222222222222222211122200222222222222222222222222222222211122200222222222222222222222222222222211122200
row36=00222222222222222222222222222222211122200222222222222222222222222222222211122200222222222222222222222222222222211122200222222222222222222222222222222211122200
row37=00222111122222222222222222222222211122200222111122222222222222222222222211122200222111122222222222222222222222211122200222111122222222222222222222222211122200
row38=00222111111111111111111111111111111122200222111111111111111111111111111111122200222111111111111111111111111111111122200222111111111111111111111111111111122200
row39=00222111111111111111111111111111111122200222111111111111111111111111111111122200222111111111111111111111111111111122200222111111111111111111111111111111122200
row40=00222111111111111111111111111111111122200222111111111111111111111111111111122200222111111111111111111111111111111122200222111111111111111111111111111111122200
row41=00222111122222222222222222222222222222200222111122222222222222222222222222222200222111122222222222222222222222222222200222111122222222222222222222222222222200
row42=00222222222222222222222222222222222222200222222222222222222222222222222222222200222222222222222222222222222222222222200222222222222222222222222222222222222200
row43=00222222222222222222222222222222222222200222222222222222222222222222222222222200222222222222222222222222222222222222200222222222222222222222222222222222222200
row44=00000000000000000000000000000000000000000000000000000000000000000000000000000000000000000000000000000000000000000000000000000000000000000000000000000000000000
row45=00000000000000000000000000000000000000000000000000000000000000000000000000000000000000000000000000000000000000000000000000000000000000000000000000000000000000
row46=00222222222222222222222222222222222222200222222222222222222222222222222222222200222222222222222222222222222222222222200222222222222222222222222222222222222200
row47=00222222222222222222222222222222222222200222222222222222222222222222222222222200222222222222222222222222222222222222200222222222222222222222222222222222222200
row48=00222222222222222222222222222222222222200222222222222222222222222222222222222200222222222222222222222222222222222222200222222222222222222222222222222222222200
row49=00222111112222222222222222222222222222200222111112222222222222222222222222222200222111112222222222222222222222222222200222111112222222222222222222222222222200
row50=00222111112222222222222222222222222222200222111112222222222222222222222222222200222111112222222222222222222222222222200222111112222222222222222222222222222200
row51=00222111111111122221111111111111111122200222111111111122221111111111111111122200222111111111122221111111111111111122200222111111111122221111111111111111122200
row52=00222111111111122221111111111111111122200222111111111122221111111111111111122200222111111111122221111111111111111122200222111111111122221111111111111111122200
row53=00222111111111122221111111111111111122200222111111111122221111111111111111122200222111111111122221111111111111111122200222111111111122221111111111111111122200
row54=00222111112211122221112222222222211122200222111112211122221112222222222211122200222111112211122221112222222222211122200222111112211122221112222222222211122200
row55=00222111112211122221112222222222211122200222111112211122221112222222222211122200222111112211122221112222222222211122200222111112211122221112222222222211122200
row56=00222222222211122221112222222222211122200222222222211122221112222222222211122200222222222211122221112222222222211122200222222222211122221112222222222211122200
row57=00222222222211122221112222222222211122200222222222211122221112222222222211122200222222222211122221112222222222211122200222222222211122221112222222222211122200
row58=00222222222211122221112222222222211122200222222222211122221112222222222211122200222222222211122221112222222222211122200222222222211122221112222222222211122200
row59=00222222222211122221112222222222211122200222222222211122221112222222222211122200222222222211122221112222222222211122200222222222211122221112222222222211122200
row60=00222111111111111111111111111222211122200222111111111111111111111111222211122200222111111111111111111111111222211122200222111111111111111111111111222211122200
row61=00222111111111111111111111111222211122200222111111111111111111111111222211122200222111111111111111111111111222211122200222111111111111111111111111222211122200
row62=00222111111111111111111111111222211122200222111111111111111111111111222211122200222111111111111111111111111222211122200222111111111111111111111111222211122200
row63=00222111222211122221112222111222211122200222111222211122221112222111222211122200222111222211122221112222111222211122200222111222211122221112222111222211122200
row64=00222111222211122221112222111222211122200222111222211122221112222111222211122200222111222211122221112222111222211122200222111222211122221112222111222211122200
row65=00222111222211122221112222111222211122200222111222211122221112222111222211122200222111222211122221112222111222211122200222111222211122221112222111222211122200
row66=00222111222211122221112222111222211122200222111222211122221112222111222211122200222111222211122221112222111222211122200222111222211122221112222111222211122200
row67=00222111222211122221112222111222211122200222111222211122221112222111222211122200222111222211122221112222111222211122200222111222211122221112222111222211122200
row68=00222111222211122221112222111222211122200222111222211122221112222111222211122200222111222211122221112222111222211122200222111222211122221112222111222211122200
row69=00222111222211122221112222111222211122200222111222211122221112222111222211122200222111222211122221112222111222211122200222111222211122221112222111222211122200
row70=00222111222211122221112222111222211122200222111222211122221112222111222211122200222111222211122221112222111222211122200222111222211122221112222111222211122200
row71=00222111222211122221112222111222211122200222111222211122221112222111222211122200222111222211122221112222111222211122200222111222211122221112222111222211122200
row72=00222111222211122221112222111222211122200222111222211122221112222111222211122200222111222211122221112222111222211122200222111222211122221112222111222211122200
row73=00222111222211122221112222111222211122200222111222211122221112222111222211122200222111222211122221112222111222211122200222111222211122221112222111222211122200
row74=00222111222211122221112222111222211122200222111222211122221112222111222211122200222111222211122221112222111222211122200222111222211122221112222111222211122200
row75=00222111111111122221111111111222211122200222111111111122221111111111222211122200222111111111122221111111111222211122200222111111111122221111111111222211122200
row76=00222111111111122221111111111222211122200222111111111122221111111111222211122200222111111111122221111111111222211122200222111111111122221111111111222211122200
row77=00222111111111122221111111111222211122200222111111111122221111111111222211122200222111111111122221111111111222211122200222111111111122221111111111222211122200
row78=00222222222222222222222222222222211122200222222222222222222222222222222211122200222222222222222222222222222222211122200222222222222222222222222222222211122200
row79=00222222222222222222222222222222211122200222222222222222222222222222222211122200222222222222222222222222222222211122200222222222222222222222222222222211122200
row80=00222222222222222222222222222222211122200222222222222222222222222222222211122200222222222222222222222222222222211122200222222222222222222222222222222211122200
row81=00222111122222222222222222222222211122200222111122222222222222222222222211122200222111122222222222222222222222211122200222111122222222222222222222222211122200
row82=00222111111111111111111111111111111122200222111111111111111111111111111111122200222111111111111111111111111111111122200222111111111111111111111111111111122200
row83=00222111111111111111111111111111111122200222111111111111111111111111111111122200222111111111111111111111111111111122200222111111111111111111111111111111122200
row84=00222111111111111111111111111111111122200222111111111111111111111111111111122200222111111111111111111111111111111122200222111111111111111111111111111111122200
row85=00222111122222222222222222222222222222200222111122222222222222222222222222222200222111122222222222222222222222222222200222111122222222222222222222222222222200
row86=00222222222222222222222222222222222222200222222222222222222222222222222222222200222222222222222222222222222222222222200222222222222222222222222222222222222200
row87=00222222222222222222222222222222222222200222222222222222222222222222222222222200222222222222222222222222222222222222200222222222222222222222222222222222222200
row88=00000000000000000000000000000000000000000000000000000000000000000000000000000000000000000000000000000000000000000000000000000000000000000000000000000000000000
row89=00000000000000000000000000000000000000000000000000000000000000000000000000000000000000000000000000000000000000000000000000000000000000000000000000000000000000

[waypoint0]
count=12
pos0=6x8
pos1=13x8
pos2=13x32
pos3=6x32
pos4=6x17
pos5=27x17
pos6=27x32
pos7=20x32
pos8=20x8
pos9=34x8
pos10=34x39
pos11=6x39

[waypoint1]
count=12
pos0=45x8
pos1=52x8
pos2=52x32
pos3=45x32
pos4=45x17
pos5=66x17
pos6=66x32
pos7=59x32
pos8=59x8
pos9=73x8
pos10=73x39
pos11=45x39

[waypoint2]
count=12
pos0=84x8
pos1=91x8
pos2=91x32
pos3=84x32
pos4=84x17
pos5=105x17
pos6=105x32
pos7=98x32
pos8=98x8
pos9=112x8
pos10=112x39
pos11=84x39

[waypoint3]
count=12
pos0=123x8
pos1=130x8
pos2=130x32
pos3=123x32
pos4=123x17
pos5=144x17
pos6=144x32
pos7=137x32
pos8=137x8
pos9=151x8
pos10=151x39
pos11=123x39

[waypoint4]
count=12
pos0=6x52
pos1=13x52
pos2=13x76
pos3=6x76
pos4=6x61
pos5=27x61
pos6=27x76
pos7=20x76
pos8=20x52
pos9=34x52
pos10=34x83
pos11=6x83

[waypoint5]
count=12
pos0=45x52
pos1=52x52
pos2=52x76
pos3=45x76
pos4=45x61
pos5=66x61
pos6=66x76
pos7=59x76
pos8=59x52
pos9=73x52
pos10=73x83
pos11=45x83

[waypoint6]
count=12
pos0=84x52
pos1=91x52
pos2=91x76
pos3=84x76
pos4=84x61
pos5=105x61
pos6=105x76
pos7=98x76
pos8=98x52
pos9=112x52
pos10=112x83
pos11=84x83

[waypoint7]
count=12
pos0=123x52
pos1=130x52
pos2=130x76
pos3=123x76
pos4=123x61
pos5=144x61
pos6=144x76
pos7=137x76
pos8=137x52
pos9=151x52
pos10=151x83
pos11=123x83

[placements]
count=0

[buyables]
count=5
filename0=C_Y_Yellow.geb
count0=0
wave0=0
kind0=building
filename1=C_G_Green.geb
count1=0
wave1=1
kind1=building
filename2=C_R_Red.geb
count2=0
wave2=2
kind2=building
filename3=C_B_Blue.geb
count3=0
wave3=3
kind3=building
filename4=C_YGRB_Colored.geb
count4=0
wave4=4
kind4=building

[wave0]
cashonstart=30
opponents=1
hint=
opponent_filename0=C_Y_Ge1.opp
opponent_count0=15
opponent_refund0=1
unitsperspawn0=1
spawndelay0=2500
spawndelta0=1000

[wave1]
cashonstart=30
opponents=1
hint=
opponent_filename0=C_G_Gr1.opp
opponent_count0=25
opponent_refund0=1
unitsperspawn0=1
spawndelay0=2500
spawndelta0=1000

[wave2]
cashonstart=50
opponents=1
hint=
opponent_filename0=C_R_R1.opp
opponent_count0=10
opponent_refund0=1
unitsperspawn0=1
spawndelay0=2500
spawndelta0=1000

[wave3]
cashonstart=20
opponents=1
hint=
opponent_filename0=C_B_B1.opp
opponent_count0=10
opponent_refund0=1
unitsperspawn0=1
spawndelay0=2500
spawndelta0=1000

[HighScore]
PlayerCats=0
Hash=0

[Rating]
Count=0
Sum=0
