[map]
size=46x50
description=
background=Doungen_2.jpg
dc1=dc1.png
dc2=dc2.png
dc3=dc3.png
dc4=dc4.png
maxplayer=3
lives0=0
lives1=0
lives2=0
type=3
waves=0

[data]
row0=0000000000000000000000000000000000000000000000
row1=0000000000000000000000000000000000000000000000
row2=0000000000000000000000000000000000000000000000
row3=0000000000000000000000000000000000000000000000
row4=0000000000000000000000000000000000000000000000
row5=0000000000000000000000033333333333333333333000
row6=0000000000000000000000033333333333333333333000
row7=0000000000000000000000033333333333333333333000
row8=0000000000000000000000033333333333333333333000
row9=0000000000000000000000033333333333333333333000
row10=0000000000000000000000033333133333333333133000
row11=0003333333333000000000033333333330000333333000
row12=0003333333333000000000033333333330000333333000
row13=0003333333333000000000033333333330000333333000
row14=0003333333333000000000033333333330000333333000
row15=0003333333333000000000000000000000000333333000
row16=0003333333333000000000000000000000000333333000
row17=0003333313333333333000000000000000000333333000
row18=0003333333333333333000000000000000000333333000
row19=0003333333333333333000000003333333300333333000
row20=0003333333333333333000000003333333300333333000
row21=0003333333333333133000000003333333300333333000
row22=0003333333333333333000000003333313300333333000
row23=0000000000000003333000000003333333300333333000
row24=0000000000000003333000000003333333300333333000
row25=0000000000000003333333300003333000000333333000
row26=0000000000000003333333300003333000000333333000
row27=0000000000033333333333300003333000000333333000
row28=0000000000033333333333300003333000000333333000
row29=0000000000033333333333333333333333000333333000
row30=0000000000033333333333333333333333000333333000
row31=0000000000033333333333333333333333333333333000
row32=0000000000033333333333333333333333333333133000
row33=0000000000033333133333300333333333333333333000
row34=0000000000033333333333300333333333333333333000
row35=0000000000033333333333300333333333333333333000
row36=0000000000033333333333300333333333333333333000
row37=0003333333333333333333300333333333300000000000
row38=0003333333333333333333300333333333300000000000
row39=0003333333333333300000000000000000000000000000
row40=0003333333333333300000000000000000000000000000
row41=0003333333333333300000000000000000000000000000
row42=0003333330033333300000000000000000000000000000
row43=0003333330033333300000000000000000000000000000
row44=0003333330033333300000000000000000000000000000
row45=0003333330033333300000000000000000000000000000
row46=0003333330033333300000000000000000000000000000
row47=0003333330000000000000000000000000000000000000
row48=0003311330000000000000000000000000000000000000
row49=0003311330000000000000000000000000000000000000

[waypoint1]
count=4
pos0=8x17
pos1=16x21
pos2=16x33
pos3=5x49

[waypoint0]
count=5
pos0=28x10
pos1=40x10
pos2=40x32
pos3=16x33
pos4=5x49

[waypoint2]
count=3
pos0=32x22
pos1=16x33
pos2=5x49

[placements]
count=0

[buyables]
count=0

[HighScore]
PlayerCats=0
Hash=0

[Rating]
Count=0
Sum=0
