[map]
size=79x73
description=
background=backtex.jpg
maxplayer=4
lives0=10
lives1=5
lives2=1
type=3
waves=0
dc1=dc1.png
dc2=dc2.png
dc3=dc3.png
dc4=dc4.png

[data]
row0=0033111113300000000000003311111330000000000000331111133000000000000033111113300
row1=0033111113300000000000003311111330000000000000331111133000000000000033111113300
row2=0033333333333333333333333333333333333333333333333333333333333333333333333333300
row3=0033333333333333333333333333333333333333333333333333333333333333333333333333300
row4=0033333333333333333333333333333333333333333333333333333333333333333333333333300
row5=0033333333333333333333333333333333333333333333333333333333333333333333333333300
row6=0033333333333333333333333333333333333333333333333333333333333333333333333333300
row7=0033333333333333333333333333333333333333333333333333333333333333333333333333300
row8=0033333333333333333333333333333333333333333333333333333333333333333333333333300
row9=0033333333333333333333333333333333333333333333333333333333333333333333333333300
row10=0033333333333333333333333333333333333333333333333333333333333333333333333333300
row11=0033333333300000000000003333333330000000000000333333333000000000000033333333300
row12=0033333333300000000000003333333330000000000000333333333000000000000033333333300
row13=0033333333300000000000003333333330000000000000333333333000000000000033333333300
row14=0033333333300000000000003333333330000000000000333333333000000000000033333333300
row15=0033333333300000000000003333333330000000000000333333333000000000000033333333300
row16=0033333333300000000000003333333330000000000000333333333000000000000033333333300
row17=0033333333300000000000003333333330000000000000333333333000000000000033333333300
row18=0033333333300000000000003333333330000000000000333333333000000000000033333333300
row19=0033333333300000000000003333333330000000000000333333333000000000000033333333300
row20=0033333333300000000000003333333330000000000000333333333000000000000033333333300
row21=0033333333300000000000003333333330000000000000333333333000000000000033333333300
row22=0033333333300000000000003333333330000000000000333333333000000000000033333333300
row23=0033333333300000000000003333333330000000000000333333333000000000000033333333300
row24=0033333333300000000000003333333330000000000000333333333000000000000033333333300
row25=0033333333300000000000003333333330000000000000333333333000000000000033333333300
row26=0033333333300000000000003333333330000000000000333333333000000000000033333333300
row27=0033333333300000000000003333333330000000000000333333333000000000000033333333300
row28=0033333333300000000000003333333330000000000000333333333000000000000033333333300
row29=0033333333300000000000003333333330000000000000333333333000000000000033333333300
row30=0033333333300000000000003333333330000000000000333333333000000000000033333333300
row31=0033333333300000000000003333333330000000000000333333333000000000000033333333300
row32=0033333333300000000000003333333330000000000000333333333000000000000033333333300
row33=0033333333300000000000033333333330000000000000333333333300000000000033333333300
row34=0033333333300000000000333333333300000000000000033333333330000000000033333333300
row35=0033333333300000000003333333333000000000000000003333333333000000000033333333300
row36=0033333333300000000033333333330000000000000000000333333333300000000033333333300
row37=0033333333300000000333333333300000000000000000000033333333330000000033333333300
row38=0033333333300000003333333333000000000000000000000003333333333000000033333333300
row39=0033333333300000033333333330000000000000000000000000333333333300000033333333300
row40=0033333333300000333333333300000000000000000000000000033333333330000033333333300
row41=0033333333330003333333333000000000000000000000000000003333333333000333333333300
row42=0003333333333033333333330000000000000000000000000000000333333333303333333333000
row43=0000333333333333333333300000000000000000000000000000000033333333333333333330000
row44=0000033333333333333333000000000000000000000000000000000003333333333333333300000
row45=0000003333333333333330000000000000000000000000000000000000333333333333333000000
row46=0000000333333333333300000000000000000000000000000000000000033333333333330000000
row47=0000000033333333333000000000000000000000000000000000000000003333333333300000000
row48=0000000003333333333000000000000000000000000000000000000000003333333333000000000
row49=0000000000333333333300000000000000000000000000000000000000033333333330000000000
row50=0000000000033333333330000000000000000000000000000000000000333333333300000000000
row51=0000000000003333333333000000000000000000000000000000000003333333333000000000000
row52=0000000000000333333333300000000000000000000000000000000033333333330000000000000
row53=0000000000000333333333330000000000000000000000000000000333333333330000000000000
row54=0000000000000333333333333000000000000000000000000000003333333333330000000000000
row55=0000000000000033333333333300000000000000000000000000033333333333300000000000000
row56=0000000000000003333333333330000000000000000000000000333333333333000000000000000
row57=0000000000000000333333333333000000000000000000000003333333333330000000000000000
row58=0000000000000000033333333333300000000000000000000033333333333300000000000000000
row59=0000000000000000003333333333330000000000000000000333333333333000000000000000000
row60=0000000000000000000333333333333000000000000000003333333333330000000000000000000
row61=0000000000000000000033333333333300000000000000033333333333300000000000000000000
row62=0000000000000000000003333333333330000000000000333333333333000000000000000000000
row63=0000000000000000000000333333333333000000000003333333333330000000000000000000000
row64=0000000000000000000000033333333333333333333333333333333300000000000000000000000
row65=0000000000000000000000003333333333333333333333333333333000000000000000000000000
row66=0000000000000000000000000333333333333333333333333333330000000000000000000000000
row67=0000000000000000000000000033333333333333333333333333300000000000000000000000000
row68=0000000000000000000000000003333333333333333333333333000000000000000000000000000
row69=0000000000000000000000000000333333333333333333333330000000000000000000000000000
row70=0000000000000000000000000000033333333333333333333300000000000000000000000000000
row71=0000000000000000000000000000003333333111113333333000000000000000000000000000000
row72=0000000000000000000000000000000333333111113333330000000000000000000000000000000

[placements]
count=0

[buyables]
count=0

[waypoint0]
count=2
pos0=6x1
pos1=39x71

[waypoint1]
count=2
pos0=72x1
pos1=39x71

[waypoint2]
count=2
pos0=28x1
pos1=39x71

[waypoint3]
count=2
pos0=50x1
pos1=39x71

[HighScore]
PlayerCats=0
