[map]
size=44x66
description=
background=ice_city.jpg
dc1=dc1.png
dc2=dc2.png
dc3=dc3.png
dc4=dc4.png
maxplayer=6
lives0=0
lives1=0
lives2=0
type=3
waves=0

[data]
row0=22222222333322222233222233222222222233222222
row1=22222222333322222233222233222222222233222222
row2=22222222333322222233222233222222222233222222
row3=22222222333322222233222233222222222233222222
row4=22222222333322222233222233333333333333333333
row5=22222222333322222233222233333333333333333333
row6=22222222333322222233222233222233223322222222
row7=22222222333322222233222233222233223322222222
row8=33333333333333333333333333333333333333333333
row9=33333333333333333333333333333333333333333333
row10=22222222333322222233222233222222222222222222
row11=22222222333322222233222233222222222222222222
row12=33333333333333333333333333333333333333333333
row13=33333333333333333333333333333333333333333333
row14=33333333333333333333333333333333333333333333
row15=33333333333333333333333333333333333333333333
row16=22222222222222332222222233222222223333222222
row17=22222222222222332222222233222222223333222222
row18=22222233322222332222223333222222223333222222
row19=22222233322222332222222222222222223333222222
row20=22222232222222332222222222332222223333222222
row21=22333332222233333222332222332222223333222222
row22=33333333333333333333333333333333333333333333
row23=33333333333333333333333333333333333333333333
row24=22332222232222332222222322222222223333333333
row25=22332222232222332222222322222222223333333333
row26=33332222232233332222222333332233223333332233
row27=33333333332233333333333333332233223333332233
row28=00000000000000330000000000000000000000000000
row29=00000000000000330000000000000000000000000000
row30=00000000000000330000000000000000000000000000
row31=00000000000000330000000000000000000000000000
row32=33332223333333332222333333333333333300003333
row33=33332223333333332222223333333333333300003222
row34=33333333333333332222222222333333333300003222
row35=33333333333333332222222222222233333300003332
row36=22332222332233333333333333222233333300003332
row37=22332222332233333333333333222222223300003332
row38=22333333332233332222223333222222223300003332
row39=33333333332233332222223333222222223300003333
row40=33333333333333333333322333333333223300003322
row41=33333333333333333322322333333333223300003322
row42=33333333333333333322322333332233223300003322
row43=33333333333333333322322333222233222300003322
row44=33333333333333333333333333222333222300003322
row45=33333333333333333333333333222333333300003322
row46=33333333333333333332222233333333333333333333
row47=33333333333333332222222233333333333333333333
row48=33333330333333332223332233222233222200003322
row49=33333333333333332223332233222233222200003322
row50=33333333333333332223332233222233222300003333
row51=33333333333333333333332233222233222300003322
row52=33333333333333332223222233222233222300003322
row53=33333333333333332223222233222233222300003333
row54=33333333333333332233333333222233223300003322
row55=33333333333333332233333333222233223300003322
row56=33333333333333333332223333222233223300003322
row57=33333333333333333333323333222233223300003322
row58=33333333223322222232223333222233223300003322
row59=22223333223322222232223333222233223300003322
row60=22222222222222222222223333222223223300003322
row61=22222222222222222222223333222223222300003322
row62=33333333333333333333333333333333222300003322
row63=33333333333333333333333333333333222300003322
row64=22333322223333222233223333222233222300003333
row65=22333322223333222233223333222233222300003333

[waypoint0]
count=2
pos0=42x5
pos1=7x48

[waypoint1]
count=2
pos0=9x2
pos1=7x48

[waypoint2]
count=2
pos0=1x14
pos1=7x48

[waypoint3]
count=2
pos0=43x26
pos1=7x48

[waypoint4]
count=2
pos0=42x65
pos1=7x48

[waypoint5]
count=2
pos0=1x63
pos1=7x48

[placements]
count=0

[buyables]
count=0

[HighScore]
PlayerCats=0
Hash=0

[Rating]
Count=0
Sum=0
