[map]
size=60x88
description=
background=backtex.jpg
maxplayer=2
lives0=10
lives1=5
lives2=1
type=3
waves=0
dc1=dc1.png
dc2=dc2.png
dc3=dc3.png
dc4=dc4.png

[data]
row0=000000000033111133000000000000000000000000331111330000000000
row1=000000000033111133000000000000000000000000331111330000000000
row2=000000000033333333000000000000000000000000333333330000000000
row3=000000000033333333000000000000000000000000333333330000000000
row4=000000000033333333000000000000000000000000333333330000000000
row5=000000000033333333000000000000000000000000333333330000000000
row6=000000000033333333000000000000000000000000333333330000000000
row7=000000000033333333000000000000000000000000333333330000000000
row8=003333333333333333333333333333333333333333333333333333333300
row9=003333333333333333333333333333333333333333333333333333333300
row10=003333333333333333333333333333333333333333333333333333333300
row11=003333333333333333333333333333333333333333333333333333333300
row12=003333333333333333333333333333333333333333333333333333333300
row13=003333333333333333333333333333333333333333333333333333333300
row14=003333333333333333333333333333333333333333333333333333333300
row15=003333333333333333333333333333333333333333333333333333333300
row16=003333333300000000000000000000000000000000000000003333333300
row17=003333333300000000000000000000000000000000000000003333333300
row18=003333333300000000000000000000000000000000000000003333333300
row19=003333333300000000000000000000000000000000000000003333333300
row20=003333333300000000000000000000000000000000000000003333333300
row21=003333333300000000000000000000000000000000000000003333333300
row22=003333333300000000000000000000000000000000000000003333333300
row23=003333333300000000000000000000000000000000000000003333333300
row24=003333333333333333333333333333333333333333333333333333333300
row25=003333333333333333333333333333333333333333333333333333333300
row26=003333333333333333333333333333333333333333333333333333333300
row27=003333333333333333333333333333333333333333333333333333333300
row28=003333333333333333333333333333333333333333333333333333333300
row29=003333333333333333333333333333333333333333333333333333333300
row30=003333333333333333333333333333333333333333333333333333333300
row31=003333333333333333333333333333333333333333333333333333333300
row32=000000000000000000000000003333333300000000000000000000000000
row33=000000000000000000000000003333333300000000000000000000000000
row34=000000000000000000000000003333333300000000000000000000000000
row35=000000000000000000000000003333333300000000000000000000000000
row36=000000000000000000000000003333333300000000000000000000000000
row37=000000000000000000000000003333333300000000000000000000000000
row38=000000000000000000000000003333333300000000000000000000000000
row39=000000000000000000000000003333333300000000000000000000000000
row40=003333333333333333333333333333333333333333333333333333333300
row41=003333333333333333333333333333333333333333333333333333333300
row42=003333333333333333333333333333333333333333333333333333333300
row43=003333333333333333333333333333333333333333333333333333333300
row44=003333333333333333333333333333333333333333333333333333333300
row45=003333333333333333333333333333333333333333333333333333333300
row46=003333333333333333333333333333333333333333333333333333333300
row47=003333333333333333333333333333333333333333333333333333333300
row48=003333333300000000000000000000000000000000000000003333333300
row49=003333333300000000000000000000000000000000000000003333333300
row50=003333333300000000000000000000000000000000000000003333333300
row51=003333333300000000000000000000000000000000000000003333333300
row52=003333333300000000000000000000000000000000000000003333333300
row53=003333333300000000000000000000000000000000000000003333333300
row54=003333333300000000000000000000000000000000000000003333333300
row55=003333333300000000000000000000000000000000000000003333333300
row56=003333333333333333333333333333333333333333333333333333333300
row57=003333333333333333333333333333333333333333333333333333333300
row58=003333333333333333333333333333333333333333333333333333333300
row59=003333333333333333333333333333333333333333333333333333333300
row60=003333333333333333333333333333333333333333333333333333333300
row61=003333333333333333333333333333333333333333333333333333333300
row62=003333333333333333333333333333333333333333333333333333333300
row63=003333333333333333333333333333333333333333333333333333333300
row64=000000000000000000000000003333333300000000000000000000000000
row65=000000000000000000000000003333333300000000000000000000000000
row66=000000000000000000000000003333333300000000000000000000000000
row67=000000000000000000000000003333333300000000000000000000000000
row68=000000000000000000000000003333333300000000000000000000000000
row69=000000000000000000000000003333333300000000000000000000000000
row70=000000000000000000000000003333333300000000000000000000000000
row71=000000000000000000000000003333333300000000000000000000000000
row72=003333333333333333333333333333333333333333333333333333333300
row73=003333333333333333333333333333333333333333333333333333333300
row74=003333333333333333333333333333333333333333333333333333333300
row75=003333333333333333333333333333333333333333333333333333333300
row76=003333333333333333333333333333333333333333333333333333333300
row77=003333333333333333333333333333333333333333333333333333333300
row78=003333333333333333333333333333333333333333333333333333333300
row79=003333333333333333333333333333333333333333333333333333333300
row80=000000000033333333000000000000000000000000333333330000000000
row81=000000000033333333000000000000000000000000333333330000000000
row82=000000000033333333000000000000000000000000333333330000000000
row83=000000000033333333000000000000000000000000333333330000000000
row84=000000000033333333000000000000000000000000333333330000000000
row85=000000000033333333000000000000000000000000333333330000000000
row86=000000000033111133000000000000000000000000331111330000000000
row87=000000000033111133000000000000000000000000331111330000000000

[placements]
count=0

[buyables]
count=0

[waypoint0]
count=2
pos0=13x1
pos1=46x86

[waypoint1]
count=2
pos0=46x1
pos1=13x86

[HighScore]
PlayerCats=0
