[map]
size=96x64
description=
background=rundekarte.png
dc1=dc1.png
dc2=dc2.png
dc3=dc3.png
dc4=dc4.png
maxplayer=9
lives0=25
lives1=10
lives2=1
type=3
waves=0

[data]
row0=222222222222222222222222311122222222222222222222221113222222222222222222222222222222222222222222
row1=222222222222222222222222311122222222222222222222221112222222222222222222222222222222222222222211
row2=222222222222222222222222233322222222222222222222233332222222222222222222222222222222222222233311
row3=222222222222222222222222233322222222222222222222233322222222222222222222222222222222222223333311
row4=222222222222222222222222223332222222222222222222233322222222222222222222222222222222222333333222
row5=222222222222222222222222223332222222222222333333333332222222222222222222222222222222223333322222
row6=222222222222222222222222222333222222223333333333333333333332222222222222222222222222333332222222
row7=222222222222222222222222222333322233333333332222333333333333332222222222222222222223333322222222
row8=113222222222222222222222222233333333333322222222333222222333333222222222222222222333332222222222
row9=113332222222222222222222222223333333222222222222333222222222333332222222222222222333322222222222
row10=113333222222222222222222222233333322222233333333333333222222233333322222222222233332222222222222
row11=222333332222222222222222223333333322233333333333333333333322222233332222222222333322222222222222
row12=222233333322222222222222233333233332333333222222333233333333222223333222222223333222222222222222
row13=222222333333222222222222333322223333333222222222332222223333332222333322222333332222222222222222
row14=222222223333333222222222333222223333322222222222332222222233333222233332223333322222222222222222
row15=222222222233333322222223332222233333222222333333333333222222333332223333333332222222222222222222
row16=222222222222333333322233332222333333323333333333333333333222233333222333333322222222222222222222
row17=222222222222223333333333322223333233333333332222332233333322222333333333333222222222222222222222
row18=222222222222222233333333222333332223333322222222332222233333222233333333333222222222222222222222
row19=222222222222222222333333322333322233333322222223332222223333322333333222333222222222222222222222
row20=222222222222222222233333333333222333333322233333333332222233333333333222233322222222222222222222
row21=222222222222222222233323333333223333223333333333333333332223333332333322233322222222222222222222
row22=222222222222222222233222233333333332223333333223322333333333333322233322223332222222222222222222
row23=222222222222222222333222233333333322233333322223322222333333333322223322223332222222222222222222
row24=222222222222222222333222333222333332233323332223322222233332223322223322223332222222222222222222
row25=222222222222222222333222333222333333333222333333333223333332223332223332222332222222222222222222
row26=222222222222222222333222332222333333333322333333333333333332223332223332222333222222222222222222
row27=113333333333333333333333333333332223333333333333333333322333222332222332222333222222222222222222
row28=113333333333333333333333333333332223333333333333333333222333222332222332222333222222222222222222
row29=112233333333333333333333333333332223322223333333333333222233222332222332222333222222222222222222
row30=222222222222222223332222332223332223322223333333333333333333333333333332222333222222222222222222
row31=222222222222222223332222332223332223322223333333333333333333333333333333333333222222222222222222
row32=222222222222222223332222332222332223333333333333333333222333222333333333333333222222222222222222
row33=222222222222222222333222333222332223333333333333333332222332223332223332222333222222222222222222
row34=222222222222222222333222333222333333333322233333333333223332223332223332222332222222222222222222
row35=222222222222222222333222233222333333333322222333322333333332223322233322223332222222222222222222
row36=222222222222222222333222233322333333233332222332222233333322233322233322223332222222222222222222
row37=222222222222222222233222233333333332223333322332222233333222333222233222233322222222222222222222
row38=222222222222222223333322223333333333222333333333333333333323333222333222233322222222222222222222
row39=222222222222222333333332333333222333322223333333333333233333332222333222233222222222222222222222
row40=222222222222333333323333333333222233332222223333332222223333322223332222333222222222222222222222
row41=222222222223333332222333332233322223333322222332222222233333322233332223333222222222222222222222
row42=222222222333333222222333322223333222333333223332222222333333333333322233332222222222222222222222
row43=222222233333322222222233322222333322223333333333333333333223333333222333322222222222222222222222
row44=222223333333222222222223332222233332222233333333333333332223333322223333222222222222222222222222
row45=222233333322222222222223333222223333322222233322222222222233333332233332222222222222222222222222
row46=223333332222222222222222333322222333333222233322222222223333323333333322222222222222222222222222
row47=113333222222222222222222233332222223333333333322222223333333222333333222222222222222222222222222
row48=113322222222222222222222233333322222233333333333333333333322222223333222222222222222222222222222
row49=112222222222222222222222333333322222222223333333333333222222222222333222222222222222222222222222
row50=322222222222222222222222333222222222222222222333332222222222222222233332222222222222222222222222
row51=222222222222222222222223332222222222222222222233333222222222222222223332222222222222222222222222
row52=222222222222222222222233332222222222222222222222333322222222222222222333222222222222222222222222
row53=222222222222222222222233322222222222222222222222233332222222222222222333322222222222222222222222
row54=222222222222222222222233322222222222222222222222223332222222222222222233332222222222222222222222
row55=222222222222222222222333222222222222222222222222222333222222222222222223333222222222222222222222
row56=222222222222222222222333222222222222222222222222222333322222222222222222333322222222222222222222
row57=222222222222222222223332222222222222222222222222222233322222222222222222233332222222222222222222
row58=222222222222222222223332222222222222222222222222222223322222222222222222223333322222222222222222
row59=222222222222222222223332222222222222222222222222222223332222222222222222222333332222222222222222
row60=222222222222222222233322222222222222222222222222222223332222222222222222222223333222222222222222
row61=222222222222222222233322222222222222222222222222222222333222222222222222222222333322222222222222
row62=222222222222222222211122222222222222222222222222222222111222222222222222222222231112222222222222
row63=222222222222222222211122222222222222222222222222222222111222222222222222222222221112222222222222

[waypoint0]
count=2
pos0=55x63
pos1=47x30

[waypoint1]
count=2
pos0=51x0
pos1=47x30

[waypoint2]
count=2
pos0=0x28
pos1=47x30

[waypoint3]
count=2
pos0=95x2
pos1=47x30

[waypoint4]
count=2
pos0=20x63
pos1=47x30

[waypoint5]
count=2
pos0=26x0
pos1=47x30

[waypoint6]
count=2
pos0=0x9
pos1=47x30

[waypoint7]
count=2
pos0=81x63
pos1=47x30

[waypoint8]
count=2
pos0=0x48
pos1=47x30

[placements]
count=0

[buyables]
count=0

[HighScore]
PlayerCats=0
Hash=0

[Rating]
Count=0
Sum=0
