[map]
size=60x60
description=
background=Spiral.JPG
dc1=dc1.png
dc2=dc2.png
dc3=dc3.png
dc4=dc4.png
maxplayer=4
lives0=0
lives1=0
lives2=0
type=0
waves=0

[data]
row0=000000000000000000000000000000000000000000000000000000000000
row1=000000000000000000000000000000000000000000000000000000000000
row2=001112222222222222221122222222222222211122222222221122221100
row3=001112222222222222221122222222222222211222222222211122221100
row4=001111222222111222221121111111111111111222222222211112211100
row5=002211122211111122222111111111111111111122222222112111111200
row6=002211112111221122111111112222222222111112222221112211112200
row7=002222111112222111111222111222222222222111112211122221122200
row8=002222111122222111122222211222222222222221111211222222222100
row9=002222111222221112222222111222222111222222211111222222211100
row10=002221112222111122222111111211222111111222222111222222111100
row11=002221122221112222211111222211222222111112222211122221112200
row12=002211222211122222111222222211222222221111122221112211122200
row13=002111222211222211112222222211222222221111112222111111222200
row14=002112222111222111222222222211222222211122111222211122222200
row15=002122221112221111122222222111111222211222211122221122222200
row16=002222221122221111122221111111111111111222221112221112222200
row17=002222211122211122111211111122222111112222222111222112222200
row18=002222111222111222211111111222222222111122222211122211222200
row19=002222112221112222211112211122222222211112222221122211222200
row20=002221112221122222111122221122222222222112222221112221111110
row21=002221122211122222111222221122222222221112222222112221111100
row22=002221122211222221112222221112222222211122222222112221112200
row23=002211122211222221122222222112222222111222211222111222112200
row24=002211222112222211122222222112222221112211111222211222112200
row25=002211111112222211222222222211222221121111111221111222112200
row26=002211111112222211222222222211112222111112221111111122112200
row27=002211221112222111111122222111111222111222221111211122112200
row28=001111221122222112211111111112211122211222221122221122112200
row29=001111221122222112222221111122221122211222221122221122111200
row30=002211221122222112222222221122221122211222221122221122211200
row31=002211221122222112222222221122222222111222221122221122211200
row32=002211221111111112221112222222222222112222221111121122111200
row33=001111221111111111111112222222112222112222221111111122111200
row34=001111222112221111111222222222112221112222211222111122112200
row35=002211222112221112222222211222112211122222211222211222112200
row36=002211122111222112222222211122111111222222111222211222112200
row37=002221122111222112222222211111111112222222112222111222112200
row38=002221122211222211222222222111111211222221112222111221122200
row39=002221112211121111122222112222222211122221122221111111122200
row40=002222112221111111112221112222222221122222222221121111112200
row41=002222111221111122111221122222222221112112222211122221111100
row42=002222211222111222211111122222222222111112222111222222221100
row43=002222211122211122221111222222222222111112221112222222222200
row44=002221221122221112222111111222222111111222211122222222222200
row45=002211121112222111222221111111111111122222111222222222112200
row46=002111222111222211122222221111111122222221112222222222111100
row47=002112222211122221111222222112222222222111122222222221111100
row48=002211222221112222211111222112222222211111222222222211121110
row49=002211122222111222221111111112222111111122222222222111222200
row50=002221112222211112222221111111111111112222222222221112222200
row51=002222111222221112222222111111111111222222211122211122222200
row52=002222211122221112222221112222222211222221111112111222222200
row53=002222221112211112222221122222222211221111122111112222222200
row54=002222211111111111122221122222222211111111222111111222222200
row55=002222111221111211112221122222222211111222222112211222222200
row56=002211112222112222112222222222222211122222222222211122222200
row57=002211122222222222222222222222222221122222222222221112222200
row58=000000000000000000000000000000000000000000000000000000000000
row59=000000000000000000000000000000000000000000000000000000000000

[waypoint0]
count=2
pos0=5x57
pos1=33x29

[waypoint1]
count=2
pos0=57x3
pos1=33x29

[waypoint2]
count=2
pos0=3x3
pos1=33x29

[waypoint3]
count=2
pos0=57x47
pos1=33x29

[placements]
count=0

[buyables]
count=0

[HighScore]
PlayerCats=0
Hash=0

[Rating]
Count=0
Sum=0
