[map]
size=70x70
description=
background=backtex.jpg
dc1=dc1.png
dc2=dc2.png
dc3=dc3.png
dc4=dc4.png
maxplayer=8
lives0=10
lives1=5
lives2=1
type=1
waves=0

[data]
row0=2222222222222222222222222222222222222222222222222222222222222222222222
row1=2222211111222222222222222222222222222222222222222222222222221111122222
row2=2222211111111111122111111221111112222111111221111112211111111111122222
row3=2222211111111111122111111221111112222111111221111112211111111111122222
row4=2222211111222221122112211221122112222112211221122112211222221111122222
row5=2111122222222221122112211221122112222112211221122112211222222222211112
row6=2111122222222221122112211221122112222112211221122112211222222222211112
row7=2111122222222221122112211221122112222112211221122112211222222222211112
row8=2111122222222221122112211221122112222112211221122112211222222222211112
row9=2111122222222221122112211221122112222112211221122112211222222222211112
row10=2211222222222221111112211221122112222112211221122111111222222222221122
row11=2211222222222221111112211221122112222112211221122111111222222222221122
row12=2211222222222222222222211221122112222112211221122222222222222222221122
row13=2211222222222222222222211221122112222112211221122222222222222222221122
row14=2211222222222222222222211221122112222112211221122222222222222222221122
row15=2211111111112222222222211221122112222112211221122222222222111111111122
row16=2211111111112222222222211221122112222112211221122222222222111111111122
row17=2222222222112222222222211221122112222112211221122222222222112222222222
row18=2222222222112222222222211111122112222112211111122222222222112222222222
row19=2211111111112222222222211111122112222112211111122222222222111111111122
row20=2211111111112222222222222222222112222112222222222222222222111111111122
row21=2211222222222222222222222222222112222112222222222222222222222222221122
row22=2211222222222222222222222222222112222112222222222222222222222222221122
row23=2211111111111111111122222222222112222112222222222211111111111111111122
row24=2211111111111111111122222222222112222112222222222211111111111111111122
row25=2222222222222222221122222222222112222112222222222211222222222222222222
row26=2222222222222222221122222222222112222112222222222211222222222222222222
row27=2211111111111111111122222222222112222112222222222211111111111111111122
row28=2211111111111111111122222222222112222112222222222211111111111111111122
row29=2211222222222222222222222222211111111111122222222222222222222222221122
row30=2211222222222222222222222222211111111111122222222222222222222222221122
row31=2211111111111111111111111111111111111111111111111111111111111111111122
row32=2211111111111111111111111111111111111111111111111111111111111111111122
row33=2222222222222222222222222222211111111111122222222222222222222222222222
row34=2222222222222222222222222222211111111111122222222222222222222222222222
row35=2222222222222222222222222222211111111111122222222222222222222222222222
row36=2222222222222222222222222222211111111111122222222222222222222222222222
row37=2211111111111111111111111111111111111111111111111111111111111111111122
row38=2211111111111111111111111111111111111111111111111111111111111111111122
row39=2211222222222222222222222222211111111111122222222222222222222222221122
row40=2211222222222222222222222222211111111111122222222222222222222222221122
row41=2211111111111111111122222222222112222112222222222211111111111111111122
row42=2211111111111111111122222222222112222112222222222211111111111111111122
row43=2222222222222222221122222222222112222112222222222211222222222222222222
row44=2222222222222222221122222222222112222112222222222211222222222222222222
row45=2211111111111111111122222222222112222112222222222211111111111111111122
row46=2211111111111111111122222222222112222112222222222211111111111111111122
row47=2211222222222222222222222222222112222112222222222222222222222222221122
row48=2211222222222222222222222222222112222112222222222222222222222222221122
row49=2211111111112222222222222222222112222112222222222222222222111111111122
row50=2211111111112222222222211111122112222112211111122222222222111111111122
row51=2222222222112222222222211111122112222112211111122222222222112222222222
row52=2222222222112222222222211221122112222112211221122222222222112222222222
row53=2211111111112222222222211221122112222112211221122222222222111111111122
row54=2211111111112222222222211221122112222112211221122222222222111111111122
row55=2211222222222222222222211221122112222112211221122222222222222222221122
row56=2211222222222222222222211221122112222112211221122222222222222222221122
row57=2211222222222222222222211221122112222112211221122222222222222222221122
row58=2211222222222221111112211221122112222112211221122111111222222222221122
row59=2211222222222221111112211221122112222112211221122111111222222222221122
row60=2111122222222221122112211221122112222112211221122112211222222222211112
row61=2111122222222221122112211221122112222112211221122112211222222222211112
row62=2111122222222221122112211221122112222112211221122112211222222222211112
row63=2111122222222221122112211221122112222112211221122112211222222222211112
row64=2111122222222221122112211221122112222112211221122112211222222222211112
row65=2222211111222221122112211221122112222112211221122112211222221111122222
row66=2222211111111111122111111221111112222111111221111112211111111111122222
row67=2222211111111111122111111221111112222111111221111112211111111111122222
row68=2222211111222222222222222222222222222222222222222222222222221111122222
row69=2222222222222222222222222222222222222222222222222222222222222222222222

[waypoint0]
count=2
pos0=6x2
pos1=34x34

[waypoint1]
count=2
pos0=63x2
pos1=35x34

[waypoint2]
count=2
pos0=67x6
pos1=35x34

[waypoint3]
count=2
pos0=67x63
pos1=35x35

[waypoint4]
count=2
pos0=63x67
pos1=35x35

[waypoint5]
count=2
pos0=6x67
pos1=34x35

[waypoint6]
count=2
pos0=2x63
pos1=34x35

[waypoint7]
count=2
pos0=2x6
pos1=34x34

[placements]
count=0

[buyables]
count=0

[HighScore]
PlayerCats=0
Hash=0

[Rating]
Count=0
Sum=0
