[map]
size=88x88
description=11 Waves
background=backtex.jpg
maxplayer=4
lives0=10
lives1=5
lives2=1
type=2
waves=11
dc1=dc1.png
dc2=dc2.png
dc3=dc3.png
dc4=dc4.png

[data]
row0=0000000000000000000000000000000000000000000000000000000000000000000000000000000000000000
row1=0000000000000000000000000000000000000000000000000000000000000000000000000000000000000000
row2=0000000000333333333333333333333333333333330000000000003333333333333333333333333333333300
row3=0000000000333333333333333333333333333333330000000000003333333333333333333333333333333300
row4=0000000000333333333333333333333333333333330000000000003333333333333333333333333333333300
row5=0000000000333333333333333333333333333333330000000000003333333333333333333333333333333300
row6=0000000000333313333333333333333333333133330000000000003333133333333333333333333331333300
row7=0000000000333333333333333333333333333333330000000000003333333333333333333333333333333300
row8=0000000000333333333333333333333333333333330000000000003333333333333333333333333333333300
row9=0000000000333333333333333333333333333333330000000000003333333333333333333333333333333300
row10=0000000000333333330000000000000000333333330000000000003333333300000000000000003333333300
row11=0000000000333333330000000000000000333333330000000000003333333300000000000000003333333300
row12=0000000000333333330000000000000000333333330000000000003333333300000000000000003333333300
row13=0000000000333333330000000000000000333333330000000000003333333300000000000000003333333300
row14=0000000000333333330000000000000000333333330000000000003333333300000000000000003333333300
row15=0000000000333333330000000000000000333333330000000000003333333300000000000000003333333300
row16=0000000000333333330000000000000000333333330000000000003333333300000000000000003333333300
row17=0000000000333333330000000000000000333333330000000000003333333300000000000000003333333300
row18=0000000000333333330000000000000000333333330000000000003333333300000000000000003333333300
row19=0000000000333333330000000000000000333333330000000000003333333300000000000000003333333300
row20=0000000000333333330000000000000000333333330000000000003333333300000000000000003333333300
row21=0000000000333333330000000000000000333333330000000000003333333300000000000000003333333300
row22=0000000000333333330000000000000000333333330000000000003333333300000000000000003333333300
row23=0000000000333333330000000000000000333333330000000000003333333300000000000000003333333300
row24=0000000000333333330000000000000000333333330000000000003333333300000000000000003333333300
row25=0000000000333333330000000000000000333333330000000000003333333300000000000000003333333300
row26=0033333333333333333333333333333333333333330000333333333333333333333333333333333333333300
row27=0033333333333333333333333333333333333333330000333333333333333333333333333333333333333300
row28=0011333333333333333333333333333333333333330000113333333333333333333333333333333333333300
row29=0011333333333333333333333333333333333133330000113333333333333333333333333333333331333300
row30=0011333333333333333333333333333333333333330000113333333333333333333333333333333333333300
row31=0011333333333333333333333333333333333333330000113333333333333333333333333333333333333300
row32=0033333333333333333333333333333333333333330000333333333333333333333333333333333333333300
row33=0033333333333333333333333333333333333333330000333333333333333333333333333333333333333300
row34=0000000000333333330000000000000000000000000000000000003333333300000000000000000000000000
row35=0000000000333333330000000000000000000000000000000000003333333300000000000000000000000000
row36=0000000000333333330000000000000000000000000000000000003333333300000000000000000000000000
row37=0000000000333333330000000000000000000000000000000000003333333300000000000000000000000000
row38=0000000000333333330000000000000000000000000000000000003333333300000000000000000000000000
row39=0000000000333333330000000000000000000000000000000000003333333300000000000000000000000000
row40=0000000000331111330000000000000000000000000000000000003311113300000000000000000000000000
row41=0000000000331111330000000000000000000000000000000000003311113300000000000000000000000000
row42=0000000000000000000000000000000000000000000000000000000000000000000000000000000000000000
row43=0000000000000000000000000000000000000000000000000000000000000000000000000000000000000000
row44=0000000000000000000000000000000000000000000000000000000000000000000000000000000000000000
row45=0000000000000000000000000000000000000000000000000000000000000000000000000000000000000000
row46=0000000000333333333333333333333333333333330000000000003333333333333333333333333333333300
row47=0000000000333333333333333333333333333333330000000000003333333333333333333333333333333300
row48=0000000000333333333333333333333333333333330000000000003333333333333333333333333333333300
row49=0000000000333333333333333333333333333333330000000000003333333333333333333333333333333300
row50=0000000000333313333333333333333333333133330000000000003333133333333333333333333331333300
row51=0000000000333333333333333333333333333333330000000000003333333333333333333333333333333300
row52=0000000000333333333333333333333333333333330000000000003333333333333333333333333333333300
row53=0000000000333333333333333333333333333333330000000000003333333333333333333333333333333300
row54=0000000000333333330000000000000000333333330000000000003333333300000000000000003333333300
row55=0000000000333333330000000000000000333333330000000000003333333300000000000000003333333300
row56=0000000000333333330000000000000000333333330000000000003333333300000000000000003333333300
row57=0000000000333333330000000000000000333333330000000000003333333300000000000000003333333300
row58=0000000000333333330000000000000000333333330000000000003333333300000000000000003333333300
row59=0000000000333333330000000000000000333333330000000000003333333300000000000000003333333300
row60=0000000000333333330000000000000000333333330000000000003333333300000000000000003333333300
row61=0000000000333333330000000000000000333333330000000000003333333300000000000000003333333300
row62=0000000000333333330000000000000000333333330000000000003333333300000000000000003333333300
row63=0000000000333333330000000000000000333333330000000000003333333300000000000000003333333300
row64=0000000000333333330000000000000000333333330000000000003333333300000000000000003333333300
row65=0000000000333333330000000000000000333333330000000000003333333300000000000000003333333300
row66=0000000000333333330000000000000000333333330000000000003333333300000000000000003333333300
row67=0000000000333333330000000000000000333333330000000000003333333300000000000000003333333300
row68=0000000000333333330000000000000000333333330000000000003333333300000000000000003333333300
row69=0000000000333333330000000000000000333333330000000000003333333300000000000000003333333300
row70=0033333333333333333333333333333333333333330000333333333333333333333333333333333333333300
row71=0033333333333333333333333333333333333333330000333333333333333333333333333333333333333300
row72=0011333333333333333333333333333333333333330000113333333333333333333333333333333333333300
row73=0011333333333333333333333333333333333133330000113333333333333333333333333333333331333300
row74=0011333333333333333333333333333333333333330000113333333333333333333333333333333333333300
row75=0011333333333333333333333333333333333333330000113333333333333333333333333333333333333300
row76=0033333333333333333333333333333333333333330000333333333333333333333333333333333333333300
row77=0033333333333333333333333333333333333333330000333333333333333333333333333333333333333300
row78=0000000000333333330000000000000000000000000000000000003333333300000000000000000000000000
row79=0000000000333333330000000000000000000000000000000000003333333300000000000000000000000000
row80=0000000000333333330000000000000000000000000000000000003333333300000000000000000000000000
row81=0000000000333333330000000000000000000000000000000000003333333300000000000000000000000000
row82=0000000000333333330000000000000000000000000000000000003333333300000000000000000000000000
row83=0000000000333333330000000000000000000000000000000000003333333300000000000000000000000000
row84=0000000000331111330000000000000000000000000000000000003311113300000000000000000000000000
row85=0000000000331111330000000000000000000000000000000000003311113300000000000000000000000000
row86=0000000000000000000000000000000000000000000000000000000000000000000000000000000000000000
row87=0000000000000000000000000000000000000000000000000000000000000000000000000000000000000000

[placements]
count=0

[buyables]
count=10
filename0=StitchTower.geb
count0=0
wave0=0
filename1=Splashtower.geb
count1=0
wave1=1
filename2=PoisonTower.geb
count2=0
wave2=2
filename3=Hecke1.geb
count3=0
wave3=5
filename4=Hecke2.geb
count4=0
wave4=5
filename5=Banktower.geb
count5=5
wave5=2
filename6=Airtower.geb
count6=0
wave6=4
filename7=Chaostower.geb
count7=0
wave7=7
filename8=Traptower.geb
count8=0
wave8=3
filename9=MagicTower.geb
count9=0
wave9=6

[waypoint0]
count=5
pos0=3x29
pos1=37x29
pos2=37x6
pos3=14x6
pos4=14x40

[waypoint1]
count=5
pos0=47x29
pos1=81x29
pos2=81x6
pos3=58x6
pos4=58x40

[waypoint2]
count=5
pos0=3x73
pos1=37x73
pos2=37x50
pos3=14x50
pos4=14x84

[waypoint3]
count=5
pos0=47x73
pos1=81x73
pos2=81x50
pos3=58x50
pos4=58x84

[wave0]
cashonstart=10
opponents=1
hint=Who lives the longest ;)
opponent_filename0=Car.opp
opponent_count0=5
opponent_refund0=1
unitsperspawn0=1
spawndelay0=2500
spawndelta0=1000

[wave1]
cashonstart=2
opponents=1
hint=
opponent_filename0=Bug.opp
opponent_count0=50
opponent_refund0=1
unitsperspawn0=1
spawndelay0=3500
spawndelta0=500

[wave2]
cashonstart=0
opponents=1
hint=
opponent_filename0=Tank3.opp
opponent_count0=4
opponent_refund0=5
unitsperspawn0=4
spawndelay0=2500
spawndelta0=1000

[wave3]
cashonstart=0
opponents=1
hint=Die you bastard
opponent_filename0=Panzer.opp
opponent_count0=1
opponent_refund0=50
unitsperspawn0=1
spawndelay0=2500
spawndelta0=1000

[wave4]
cashonstart=0
opponents=1
hint=It's poison time
opponent_filename0=Opponent1.opp
opponent_count0=5
opponent_refund0=1
unitsperspawn0=1
spawndelay0=5000
spawndelta0=250

[wave5]
cashonstart=0
opponents=2
hint=Let the fun begin ;)
opponent_filename0=Bug.opp
opponent_count0=100
opponent_refund0=1
unitsperspawn0=5
spawndelay0=2500
spawndelta0=500
opponent_filename1=Mouse.opp
opponent_count1=10
opponent_refund1=1
unitsperspawn1=1
spawndelay1=2500
spawndelta1=1000

[wave6]
cashonstart=0
opponents=1
hint=Air !!!
opponent_filename0=Bird.opp
opponent_count0=2
opponent_refund0=1
unitsperspawn0=1
spawndelay0=2500
spawndelta0=10000

[wave7]
cashonstart=0
opponents=2
hint=
opponent_filename0=Bird.opp
opponent_count0=4
opponent_refund0=1
unitsperspawn0=1
spawndelay0=2500
spawndelta0=1000
opponent_filename1=Car.opp
opponent_count1=25
opponent_refund1=1
unitsperspawn1=1
spawndelay1=2500
spawndelta1=500

[wave8]
cashonstart=0
opponents=3
hint=
opponent_filename0=Tank1.opp
opponent_count0=4
opponent_refund0=1
unitsperspawn0=1
spawndelay0=3000
spawndelta0=1000
opponent_filename1=Starfighter.opp
opponent_count1=4
opponent_refund1=1
unitsperspawn1=1
spawndelay1=5000
spawndelta1=2000
opponent_filename2=Car2.opp
opponent_count2=10
opponent_refund2=1
unitsperspawn2=1
spawndelay2=2500
spawndelta2=1000

[wave9]
cashonstart=25
opponents=1
hint=
opponent_filename0=Balloon Blue.opp
opponent_count0=6
opponent_refund0=5
unitsperspawn0=1
spawndelay0=2500
spawndelta0=2500

[wave10]
cashonstart=50
opponents=4
hint=Can you beat them all ?
opponent_filename0=Panzer.opp
opponent_count0=7
opponent_refund0=1
unitsperspawn0=1
spawndelay0=2500
spawndelta0=1500
opponent_filename1=Spider.opp
opponent_count1=2
opponent_refund1=1
unitsperspawn1=1
spawndelay1=2500
spawndelta1=5000
opponent_filename2=Duck.opp
opponent_count2=10
opponent_refund2=1
unitsperspawn2=1
spawndelay2=2500
spawndelta2=2000
opponent_filename3=Hubi.opp
opponent_count3=3
opponent_refund3=1
unitsperspawn3=1
spawndelay3=2500
spawndelta3=3000

[HighScore]
PlayerCats=0
