[map]
size=48x60
description=
background=Labyrinth.JPG
dc1=dc1.png
dc2=dc2.png
dc3=dc3.png
dc4=dc4.png
maxplayer=6
lives0=0
lives1=0
lives2=0
type=1
waves=0

[data]
row0=222222222222222222222222222222222222222222222222
row1=222222222222222222222222222222222222222222222222
row2=333333332233333333333333333333333333333333333322
row3=333333332233333333333333333333333333333333333322
row4=223322332222222222222222222222332222332222223322
row5=223322332222222222222222222222332222332222223322
row6=223322333333333333333333333322333322333333223322
row7=223322333333333333333333333322333322333333223322
row8=223322222222222222222222223322222222222233223322
row9=223322222222222222222222223322222222222233223322
row10=223322333333333333332233223333333333332233223322
row11=223322333333333333332233223333333333332233223322
row12=223322332222222222332233222222222222332233223322
row13=223322332222222222332233222222222222332233223322
row14=223333332233333322332233333333333333332233223322
row15=223333332233333322332233333333333333332233223322
row16=223322222233223322332222222222222222332233222222
row17=223322222233223322332222222222222222332233222222
row18=223322333333223322332233333333333322332233333322
row19=223322333333223322332233333333333322332233333322
row20=223322332222223322332233222222223322332222223322
row21=223322332222223322332233222222223322332222223322
row22=223333332233223322333333223333333322333333223322
row23=223333332233223322333333223333333322333333223322
row24=222222222233223322222222223322223322222233223322
row25=222222222233223322222222223322223322222233223322
row26=223333332233223333223333223322333322332233333322
row27=223333332233223333223333223322333322332233333322
row28=223322332233333333223322223322222222332222222222
row29=223322332233333333223322223322222222332222222222
row30=223322333333332233333333223333333333333333333322
row31=223322333333332233333333223333333333333333333322
row32=223322222222222233222222223322222222222222223322
row33=223322222222222233222222223322222222222222223322
row34=223322333333333333223333333333333333332233223322
row35=223322333333333333223333333333333333332233223322
row36=223322332222222222223322222222222222332233223322
row37=223322332222222222223322222222222222332233223322
row38=223322332233333333223322333333333322332233223322
row39=223322332233333333223322333333333322332233223322
row40=223333332233332233223333332233223333333333223322
row41=223333332233332233223333332233223333333333223322
row42=223322222222222233222222222222222222222233223322
row43=223322222222222233222222222222222222222233223322
row44=223322333333333333333333333322333333332233223322
row45=223322333333333333333333333322333333332233223322
row46=223322222233222222222222223322332222222233223322
row47=223322222233222222222222223322332222222233223322
row48=223333333333223333333333223322333333333333223322
row49=223333333333223333333333223322333333333333223322
row50=222222222222223322222233223322222222222233222222
row51=222222222222223322222233223322222222222233222222
row52=223333332233333333332233223322333333332233223322
row53=223333332233333333332233223322333333332233223322
row54=223322222233222222332222223322332222222233223322
row55=223322222233222222332222223322332222222233223322
row56=223333333333333322333333333333333333333333333333
row57=223333333333333322333333333333333333333333333333
row58=222222222222222222222222222222222222222222222222
row59=222222222222222222222222222222222222222222222222

[waypoint0]
count=2
pos0=6x53
pos1=0x3

[waypoint1]
count=2
pos0=10x3
pos1=47x57

[waypoint2]
count=2
pos0=44x49
pos1=0x3

[waypoint3]
count=2
pos0=44x15
pos1=47x57

[waypoint4]
count=2
pos0=10x41
pos1=0x3

[waypoint5]
count=2
pos0=22x11
pos1=47x57

[placements]
count=0

[buyables]
count=0

[HighScore]
PlayerCats=0
Hash=0

[Rating]
Count=0
Sum=0
