[map]
size=88x96
description=
background=Background.png
dc1=dc1.png
dc2=dc2.png
dc3=dc3.png
dc4=dc4.png
maxplayer=4
lives0=25
lives1=10
lives2=1
type=3
waves=0

[data]
row0=2222222222222222222222222222222222222222111111122222222222211111112222222222222222222222
row1=2222222222222222222222222222222222222222111111122222222222211111112222222222222222222222
row2=2222222222222222222222222222222222222222221112222222222222222111222222222222222222222222
row3=2222222222222222222222222222222222222222221112222222222222222111222222222222222222222222
row4=2222222222222222222222222222222222222222221112222222222222222111222222222222222222222222
row5=2222222222222222222222222222222222222222221112222222222222222111222222222222222222222222
row6=2222222222222222222222222222222222222222221112222222222222222111222222222222222222222222
row7=2222222222222222222222222222222222222222221112222222222222222111222222222222222222222222
row8=2222222222222222222222222222222222222222221112222222222222222111222222222222222222222222
row9=2222222222222222222222222222222222222222221112222222222222222111222222222222222222222222
row10=2222222222222222222222222222222222222222221112222222222222222111222222222222222222222222
row11=2222222222222222222222222222222222222222221112222222222222222111222222222222222222222222
row12=2222222222222222222222222222222222222222221112222222222222222111222222222222222222222222
row13=2222222222222222222222222222222222222222221112222222222222222111222222222222222222222222
row14=2222222222222222222222222222222222222222221112222222222222222111222222222222222222222222
row15=2222222222222222222222222222222222222222221112222222222222222111222222222222222222222222
row16=2233333333333333333333333333332222222222221112222222222222222111222222222222222222222222
row17=2233333333333333333333333333332222222222221112222222222222222111222222222222222222222222
row18=2233333333333333333333333333332222223333333333333333333333333333333333222222222222222222
row19=2233333333333333333333333333332222223333333333333333333333333333333333222222222222222222
row20=2233333333333333333333333333332222223333333333333333333333333333333333222222222222222222
row21=2233333333333333333333333333332222223333333333333333333333333333333333222222222222222222
row22=2233333333333333333333333333332222223333333333333333333333333333333333222222222222222211
row23=2233333333333333333333333333332222223333333333333333333333333333333333222222222222222211
row24=2233333333333333333333333333331111113333333333333333333333333333333333111111111111111111
row25=2233333333333333333333333333331111113333333333333333333333333333333333111111111111111111
row26=2233333333333333333333333333331111113333333333333333333333333333333333111111111111111111
row27=2233333333333333333333333333332222223333333333333333333333333333333333222222222222222211
row28=2233333333333333333333333333332222223333333333333333333333333333333333222222222222222211
row29=2233333333333333333333333333332222223333333333333333333333333333333333222222222222222222
row30=2233333333333333333333333333332222223333333333333333333333333333333333222222222222222222
row31=2233333333333333333333333333332222223333333333333333333333333333333333222222222222222222
row32=2233333333333333333333333333332222223333333333333333333333333333333333222222222222222222
row33=2233333333333333333333333333331111113333333333333333333333333333333333222222222222222222
row34=2233333333333333333333333333331111113333333333333333333333333333333333222222222222222222
row35=2233333333333333333333333333331111113333333333333333333333333333333333222222222222222222
row36=2233333333333333333333333333332222223333333333333333333333333333333333222222222222222222
row37=2233333333333333333333333333332222223333333333333333333333333333333333222222222222222222
row38=2233333333333333333333333333332222223333333333333333333333333333333333222222222222222222
row39=2233333333333333333333333333332222223333333333333333333333333333333333222222222222222222
row40=2233333333333333333333333333332222223333333333333333333333333333333333222222222222222222
row41=2233333333333333333333333333332222223333333333333333333333333333333333222222222222222211
row42=2233333333333333333333333333332222223333333333333333333333333333333333222222222222222211
row43=2233333333333333333333333333332222223333333333333333333333333333333333111111111111111111
row44=2222222222111222222111222222222222223333333333333333333333333333333333111111111111111111
row45=2222222222111222222111222222222222223333333333333333333333333333333333111111111111111111
row46=2222222222111222222111222222222222223333333333333333333333333333333333222222222222222211
row47=2222222222111222222111222222222222223333333333333333333333333333333333222222222222222211
row48=2222222222111222222111222222222222223333333333333333333333333333333333222222222222222222
row49=2222222222111222222111222222222222223333333333333333333333333333333333222222222222222222
row50=2222222222111222222111222222222222223333333333333333333333333333333333222222222222222222
row51=2222222222111222222111222222222222223333333333333333333333333333333333222222222222222222
row52=2222222222111222222111222222222222222222222222222222222222222222222222222222222222222222
row53=2222222222111222222111222222222222222222222222222222222222222222222222222222222222222222
row54=2222222222111222222111222222222222222222222222222222222222222222222222222222222222222222
row55=2222222222111222222111222222222222222222222222222222222222222222222222222222222222222222
row56=2222222222111222222111222222222222222222222222222222222222222222222222222222222222222222
row57=2222222222111222222111222222222222222222222222222222222222222222222222222222222222222222
row58=2222222222111222222111222222222222222222222222222222222222222222222222222222222222222222
row59=2222222222111222222111222222222222222222222222222222222222222222222222222222222222222222
row60=2233333333333333333333333333333333332222222222222222222222222222222222222222222222222222
row61=2233333333333333333333333333333333332222222222222222222222222222222222222222222222222222
row62=2233333333333333333333333333333333332222222222222222222233333333333333333333333322222222
row63=2233333333333333333333333333333333332222222222222222222233333333333333333333333322222222
row64=2233333333333333333333333333333333332222222222222222222233333333333333333333333322222222
row65=2233333333333333333333333333333333332222222222222222222233333333333333333333333322222222
row66=2233333333333333333333333333333333332222221111111111111133333333333333333333333322222222
row67=2233333333333333333333333333333333332222221111111111111133333333333333333333333322222222
row68=2233333333333333333333333333333333332222221111111111111133333333333333333333333322222222
row69=2233333333333333333333333333333333332222221112222222222223333333333333333333333322222222
row70=2233333333333333333333333333333333332222221112222222222223333333333333333333333322222222
row71=2233333333333333333333333333333333332222221112222222222223333333333333333333333322222222
row72=2233333333333333333333333333333333332222221112222222222223333333333333333333333322222222
row73=2233333333333333333333333333333333332222221112222222222223333333333333333333333322222222
row74=2233333333333333333333333333333333332222221112222222222223333333333333333333333322222222
row75=2233333333333333333333333333333333332222221112211111111133333333333333333333333322222222
row76=2233333333333333333333333333333333331111111112211111111133333333333333333333333322222222
row77=2233333333333333333333333333333333331111111112211111111133333333333333333333333322222222
row78=2233333333333333333333333333333333331111111112211122222233333333333333333333333322222222
row79=2233333333333333333333333333333333322222222222211122222233333333333333333333333322222222
row80=2233333333333333333333333333333333322222222222211122222233333333333333333333333322222222
row81=2233333333333333333333333333333333322222222222211122222233333333333333333333333322222222
row82=2233333333333333333333333333333333322222222222211122222233333333333333333333333311111122
row83=2233333333333333333333333333333333322222222222211122222233333333333333333333333311111122
row84=2233333333333333333333333333333333322222222222211122222233333333333333333333333311111122
row85=2233333333333333333333333333333333331111111111111122222233333333333333333333333222211122
row86=2233333333333333333333333333333333331111111111111122222222222222222222222222111222211122
row87=2233333333333333333333333333333333331111111111111122222222222222222222222222111222211122
row88=2233333333333333333333333333333333332222222222222222222222222222222222222222111222211122
row89=2233333333333333333333333333333333332222222222222222222222222222222222222222111111111122
row90=2233333333333333333333333333333333332222222222222222222222222222222222222222111111111122
row91=2233333333333333333333333333333333332222222222222222222222222222222222222222111111111122
row92=2233333333333333333333333333333333332222222222222222222222222222222222222222222222222222
row93=2233333333333333333333333333333333332222222222222222222222222222222222222222222222222222
row94=2222222222222222222222222222222222222222222222222222222222222222222222222222222222222222
row95=2222222222222222222222222222222222222222222222222222222222222222222222222222222222222222

[waypoint0]
count=13
pos0=43x1
pos1=43x17
pos2=35x25
pos3=30x25
pos4=11x44
pos5=11x59
pos6=36x86
pos7=48x86
pos8=48x76
pos9=55x76
pos10=80x83
pos11=84x83
pos12=84x90

[waypoint1]
count=13
pos0=86x44
pos1=70x44
pos2=35x34
pos3=30x34
pos4=20x44
pos5=20x59
pos6=36x77
pos7=43x77
pos8=43x67
pos9=55x67
pos10=77x86
pos11=77x90
pos12=84x90

[waypoint2]
count=13
pos0=62x1
pos1=62x17
pos2=35x25
pos3=30x25
pos4=11x44
pos5=11x59
pos6=36x86
pos7=48x86
pos8=48x76
pos9=55x76
pos10=80x83
pos11=84x83
pos12=84x90

[waypoint3]
count=13
pos0=86x25
pos1=70x25
pos2=35x34
pos3=30x34
pos4=20x44
pos5=20x59
pos6=36x77
pos7=43x77
pos8=43x67
pos9=55x67
pos10=77x86
pos11=77x90
pos12=84x90

[placements]
count=0

[buyables]
count=0

[HighScore]
PlayerCats=0
Hash=0

[Rating]
Count=0
Sum=0
