[map]
size=62x62
description=
background=green.jpg
dc1=dc1.png
dc2=dc2.png
dc3=dc3.png
dc4=dc4.png
maxplayer=4
lives0=0
lives1=0
lives2=0
type=3
waves=0

[data]
row0=33333333333333333333333333333333333333333333333333333333333333
row1=33333333333333333333333333333333333333333333333333333333333333
row2=33111333333333333333333333333333333333333300000033330000000033
row3=33111333333333333333333333333333333333333333333033333333333333
row4=33111333330000003333330000000000000333333333333033333333333333
row5=33333333330333333333333333333333333333333333333033333333333333
row6=33333333330333333333333333333333333333303333333033333333333111
row7=33333303330333333333333333333333333333303333333033333333333111
row8=33333303330333000000033333333333333333303333333033300000003111
row9=33333303330333033333333333333333333333303333333033333333303333
row10=33333303333333033333333333333000000000003333333033333333303333
row11=33333303333333033333333333333333333333303333333033333333303333
row12=33333303333333033333333333333333333333303333333033333333303333
row13=33333303333333033333333333333333333333303333333033333333303333
row14=33000003333333033333333333333333330000003333333033303333303333
row15=33333333333333033333333333333333333333303333333333303333303333
row16=33333333333333033300000003333333333333303333333333303333303333
row17=33033333333333333303333303333333333333333333333333303333303333
row18=33033333333333333303333303333333333333333033333333303333303333
row19=33033333333333333303333303333333333333333033333333303333303333
row20=33033333333333333303333303333000000000033033333333303333303333
row21=33033333033333333303333303333333333333333033333333303333303333
row22=33033333033333333303333303333333333333333033333333333333303333
row23=33033333033333333333333303333333333333333033333333333333333333
row24=33033333000003333333333303333333333333333033333333333333333333
row25=33033333033333330333333303333333333333333030000000033333333333
row26=33033333033333330333333303333333333333333033333333333330333333
row27=33033333033333330333333303333333113333333033333333333330333333
row28=33033333033333330333333303333331111333333033333333333330333333
row29=33033333033333330333333333333331111333333033333333333330333333
row30=33033333033333330333333333333331111333333033333333333330333333
row31=33333333033303330000000003333333113333333033333333333330333333
row32=33333333333303333333333333333333333333333033333333333330333333
row33=33330333333303333333333333333333333333333033333330333330333333
row34=33330333333303333333333333333333333333333333333330333330333333
row35=33330333333303333333333333333333333333333333333330333330333333
row36=33330333333303333333333333333333333333333333333330333330333333
row37=33330333333303333333333333333333333330000000003330333330333333
row38=33330333333303333333333333333333333330333333333330333333333333
row39=33330333333303333333000000000000033330333333333330333333333333
row40=33330333333303333333333333333333333330333333333330333333333333
row41=33330333333303333333333333333333333330333333333330333333333333
row42=33330333333303333333333333333333333330333333333330333333333333
row43=33330333333303333333333333333333333330333333333330333333333333
row44=33330333333333333333333333333333333330333333333330333333333333
row45=33330000003333000000000033333333333330333333333330330000000033
row46=33333333333333333333333333333333333330333033333330333333333333
row47=33333333333333333303333333333333333330333033333330333333333333
row48=33333333033333333303333333333333333330333033333330333333333333
row49=30000033033333333303330333000000033330333033333333333333333333
row50=33033333033333333303330333333333333333333033333333333033333333
row51=33033333033333333303330333333333333333333033333333333033333333
row52=33033333033333333303330333333333333333333033333333333033333333
row53=33033333033333333303330333333333333333333033333333333033333333
row54=33033333033333333303330333333333333333333033333333333033333333
row55=33033333000000333303330333333333000000000033333300000033333333
row56=33033333333333333333330333333333333333333033333333333333333333
row57=33033333333333333333330333333333333333333033333333333333333111
row58=33333333333333333333330333333333333333333333333333333333333111
row59=33111330000000000033330333330000000000333333333333333333333111
row60=33111333333333333333333333333333333333333333333333333333333333
row61=33111333333333333333333333333333333333333333333333333333333333

[waypoint0]
count=2
pos0=60x7
pos1=33x28

[waypoint1]
count=2
pos0=3x60
pos1=32x30

[waypoint2]
count=2
pos0=60x58
pos1=33x30

[waypoint3]
count=2
pos0=3x3
pos1=32x28

[placements]
count=0

[buyables]
count=0

[HighScore]
PlayerCats=0
Hash=0

[Rating]
Count=0
Sum=0
