[map]
size=58x58
description=
background=Background.png
dc1=dc1.png
dc2=dc2.png
dc3=dc3.png
dc4=dc4.png
maxplayer=2
lives0=25
lives1=10
lives2=1
type=1
waves=0

[data]
row0=2222222222222222222222222222222222222222222222222222222222
row1=2222222222222222222222222222222222222222222222222222222222
row2=2222222222222222222211111111111111111111112222222222222222
row3=2222222222222222222211111111111111111111112222222222222222
row4=2222222222222222222211111111111111111111112222222222222222
row5=2222222222222222222211122222222222222221112222222222222222
row6=2222222222222222222211122222222222222221112222222222222222
row7=2222222222222222222211122222222222222221112222222222222222
row8=2222222222222222222211122222222222222221112222222222222222
row9=2222222222222222222211111111111111122221112222222222222222
row10=2222222222222222222211111111111111122221111111111111111111
row11=2222222222222222222211111111111111122221111111111111111111
row12=2222222222222222222222222222222211122221111111111111111111
row13=2222222222222222222222222222222211122222222222222222222220
row14=2222222222222222222222222222222211122222222222222222222220
row15=2222222222222222222222222222222211122222222222222222222220
row16=2222222222222222222222221111111111122222222222222222222220
row17=2222222222222222222222221111111111111111111222222222222220
row18=2222222222222222222222221111111111111111111222222222222220
row19=2222222222222222222222221111111111111111111222222222222220
row20=2211111111112222222222221111222222222222111222222222222220
row21=2211111111112222222222221111222222222222111222222222222220
row22=2211111111112222222222221111222222222222111222222222222220
row23=2211122221112222222222221111222222222222111222222222222220
row24=2211122221112222111111111111222222222222111222222222222220
row25=2211122221112222111111111111222222222222111222222222222220
row26=2211122221112222111111111111222222111111111222222222222220
row27=2211122221112222111111111111222222111111111222222222222220
row28=2211122221112222111122222222222222111111111222222222222220
row29=2211122221112222111122222222222222111222222222222222222220
row30=2211122221112222111122222222222222111222222222222222222220
row31=2211122221112222111122222222222222111111122222222222222220
row32=2211122221111111111122222222222222111111122222222222222220
row33=2211122221111111111122222222222222111111122222222222222220
row34=2211122221111111111122222211111111222211122222222222222220
row35=2211122222222222211122222211111111222211122222222222222220
row36=2211122222222222211122222211111111222211122222222222222220
row37=2211122222222222211122222211122111222211111111111112222220
row38=2211122222222222211122222211122111111111111111111112222220
row39=2211111111111222211122222211122111111111111111111112222220
row40=2211111111111222211111111111122111111111222222221112222220
row41=2211111111111222211111111111122222222111222222221112222220
row42=2222222222111222211111111111122222222111222222221112222220
row43=2222222222111222222222222222222222222111222222221112222220
row44=2222222222111222222222222222222222222111222222221112222220
row45=2222222222111222222222222222222222222111222222221112222220
row46=2222222222111222222222222222222222222111222222221112222220
row47=2222222222111222222222222222222222222111222222221112222220
row48=2222222222111222222222222222222222222111111111111112222220
row49=2222222222111222222222222222222222222111111111111112222220
row50=2222222222111222222222222222222222222111111111111112222220
row51=2222222222111222222222222222222222222222222222222222222220
row52=2222222222111222222222222222222222222222222222222222222220
row53=2222222222111222222222222222222222222222222222222222222220
row54=2222222222111222222222222222222222222222222222222222222220
row55=2222222222111222222222222222222222222222222222222222222220
row56=2222222222111222222222222222222222222222222222222222222220
row57=2222222222111000000000000000000000000000000000000000000000

[waypoint0]
count=19
pos0=49x49
pos1=38x49
pos2=38x39
pos3=39x38
pos4=39x32
pos5=35x32
pos6=35x27
pos7=41x27
pos8=41x18
pos9=26x18
pos10=26x26
pos11=18x26
pos12=18x33
pos13=10x33
pos14=10x21
pos15=3x21
pos16=3x40
pos17=11x40
pos18=11x57

[waypoint1]
count=19
pos0=49x49
pos1=49x38
pos2=39x38
pos3=38x39
pos4=32x39
pos5=32x35
pos6=27x35
pos7=27x41
pos8=18x41
pos9=18x26
pos10=26x26
pos11=26x18
pos12=33x18
pos13=33x10
pos14=21x10
pos15=21x3
pos16=40x3
pos17=40x11
pos18=57x11

[placements]
count=0

[buyables]
count=0

[HighScore]
PlayerCats=0
Hash=0

[Rating]
Count=0
Sum=0
