[map]
size=40x52
description=
background=backtex.jpg
maxplayer=2
lives0=10
lives1=5
lives2=1
type=3
waves=0
dc1=dc1.png
dc2=dc2.png
dc3=dc3.png
dc4=dc4.png

[data]
row0=0000000000000000000000000000000000000000
row1=0000000000000000000000000000000000000000
row2=3333333333333333333333333333333333333300
row3=3333333333333333333333333333333333333300
row4=1133333333333333333333333333333333333300
row5=1133333333333333333333333333333333333300
row6=1133333333333333333333333333333333333300
row7=1133333333333333333333333333333333333300
row8=3333333333333333333333333333333333333300
row9=3333333333333333333333333333333333333300
row10=0000000000000000000000000000003333333300
row11=0000000000000000000000000000003333333300
row12=3333333333333333333333333333333333333300
row13=3333333333333333333333333333333333333300
row14=3333333333333333333333333333333333333300
row15=3333333333333333333333333333333333333300
row16=3333333333333333333333333333333333333300
row17=3333333333333333333333333333333333333300
row18=3333333333333333333333333333333333333300
row19=3333333333333333333333333333333333333300
row20=3333333300000000000000000000000000000000
row21=3333333300000000000000000000000000000000
row22=3333333333333333333333333333333333333333
row23=3333333333333333333333333333333333333333
row24=3333333333333333333333333333333333333311
row25=3333333333333333333333333333333333333311
row26=3333333333333333333333333333333333333311
row27=3333333333333333333333333333333333333311
row28=3333333333333333333333333333333333333333
row29=3333333333333333333333333333333333333333
row30=3333333300000000000000000000000000000000
row31=3333333300000000000000000000000000000000
row32=3333333333333333333333333333333333333300
row33=3333333333333333333333333333333333333300
row34=3333333333333333333333333333333333333300
row35=3333333333333333333333333333333333333300
row36=3333333333333333333333333333333333333300
row37=3333333333333333333333333333333333333300
row38=3333333333333333333333333333333333333300
row39=3333333333333333333333333333333333333300
row40=0000000000000000000000000000003333333300
row41=0000000000000000000000000000003333333300
row42=3333333333333333333333333333333333333300
row43=3333333333333333333333333333333333333300
row44=1133333333333333333333333333333333333300
row45=1133333333333333333333333333333333333300
row46=1133333333333333333333333333333333333300
row47=1133333333333333333333333333333333333300
row48=3333333333333333333333333333333333333300
row49=3333333333333333333333333333333333333300
row50=0000000000000000000000000000000000000000
row51=0000000000000000000000000000000000000000

[placements]
count=0

[buyables]
count=0

[waypoint0]
count=2
pos0=0x5
pos1=39x26

[waypoint1]
count=2
pos0=0x46
pos1=39x25

[HighScore]
PlayerCats=0
