[map]
size=85x47
description=
background=backtex.jpg
maxplayer=2
lives0=10
lives1=5
lives2=1
type=3
waves=0
dc1=dc1.png
dc2=dc2.png
dc3=dc3.png
dc4=dc4.png

[data]
row0=2222222222222222222222222222222222222222222222222222222222222222222222222222222222222
row1=2222222222222222222222222222222222222222222222222222222222222222222222222222222222222
row2=2233333333333333222222222333333333333333333333332222222222222222233333333333333333322
row3=2233333333333333222222222333333333333333333333332222222222222222233333333333333333322
row4=2233333333333333222222222333333333333333333333332222222222222222233333333333333333322
row5=2233333333333333222222222333333333333333333333332222222222222222233333333333333333322
row6=2233331111113333222222222333333333333333333333332222233333333333333333333111111333322
row7=2233331111113333222222222333333333333333333333332222233333333333333333333111111333322
row8=2233331111113333222222222333333222222222223333332222233333333333333333333111111333322
row9=2233331111113333222222222333333222222222223333332222233333333333333333333111111333322
row10=2233331111113333222222222333333222222222223333332222233333333333333333333111111333322
row11=2233331111113333222222222333333222222222223333332222233333333333333333333111111333322
row12=2233333333333333222222222333333222222222223333332222233333322222233333333333333333322
row13=2233333333333333222222222333333222222222223333332222233333322222233333333333333333322
row14=2233333333333333222222222333333222222222223333332222233333322222233333333333333333322
row15=2233333333333333222222222333333222222222223333332222233333322222233333333333333333322
row16=2233333333333333222222222333333222222222223333332222233333322222222222222222222222222
row17=2233333333333333222222222333333222222222223333332222233333322222222222222222222222222
row18=2233333333333333222222222333333222222222223333333333333333322222222222222222222222222
row19=2233333333333333222222222333333222222222223333333333333333322222222222222222222222222
row20=2222223333332222222222222333333222222222223333333333333333322222222222222222222222222
row21=2222223333332222222222222333333222222222223333333333333333322222222222222222222222222
row22=2222223333332222222222222333333222222222223333333333333333322222222222222222222222222
row23=2222223333332222222222222333333222222222223333333333333333322222222222222222222222222
row24=2222223333332222222222222333333222222222223333332222222222222222222222222222222222222
row25=2222223333332222222222222333333222222222223333332222222222222222222222222222222222222
row26=2222223333332222222222222333333222222222223333332222222222222222222222222222222222222
row27=2222223333332222222222222333333222222222223333332222222222222222222222222222222222222
row28=2222223333332222222222222333333222222222223333332222222222222222222222222222222222222
row29=2222223333332222222222222333333222222222223333332222222222222222222222222222222222222
row30=2222223333332222222222222333333222222222223333332222222222222222222222222222222222222
row31=2222223333332222222222222333333222222222223333332222222222222222233333333333333333322
row32=2222223333332222222222222333333222222222223333332222222222222222233333333333333333322
row33=2222223333332222222222222333333222222222223333332222222222222222233333333333333333322
row34=2222223333332222222222222333333222222222223333332222222222222222233333333333333333322
row35=2222223333332222222222222333333222222222223333333333333333333333333333333111111333322
row36=2222223333332222222222222333333222222222223333333333333333333333333333333111111333322
row37=2222223333332222222222222333333222222222223333333333333333333333333333333111111333322
row38=2222223333332222222222222333333222222222223333333333333333333333333333333111111333322
row39=2222223333333333333333333333333222222222223333333333333333333333333333333111111333322
row40=2222223333333333333333333333333222222222223333333333333333333333333333333111111333322
row41=2222223333333333333333333333333222222222222222222222222222222222233333333333333333322
row42=2222223333333333333333333333333222222222222222222222222222222222233333333333333333322
row43=2222223333333333333333333333333222222222222222222222222222222222233333333333333333322
row44=2222223333333333333333333333333222222222222222222222222222222222233333333333333333322
row45=2222222222222222222222222222222222222222222222222222222222222222222222222222222222222
row46=2222222222222222222222222222222222222222222222222222222222222222222222222222222222222
row47=33333333333333333333333333333333333333333333333333
row48=33333333333333333333333333333333333333333333333333
row49=33333333333333333333333333333333333333333333333333

[placements]
count=0

[buyables]
count=0

[waypoint0]
count=2
pos0=76x38
pos1=8x8

[waypoint1]
count=2
pos0=75x9
pos1=8x9

[HighScore]
PlayerCats=0
