[map]
size=69x69
description=
background=backtex.jpg
maxplayer=8
lives0=10
lives1=5
lives2=1
type=3
waves=0
dc1=dc1.png
dc2=dc2.png
dc3=dc3.png
dc4=dc4.png

[data]
row0=222222222222222222222222222222222222222222222222222222222222222222222
row1=222222222222222222222222222222222222222222222222222222222222222222222
row2=221111333222222222222222222222222222222222222222222222222222333111122
row3=221111133222222222222222222222222222222222222222222222222222331111122
row4=221111113222222222222222222222222222222222222222222222222222311111122
row5=221111111222222222222222222222222222222222222222222222222222111111122
row6=223111111111111111111122222222222222222222222221111111111111111111322
row7=223311111111111111111122222222222222222222222221111111111111111113322
row8=223331111111111111111122222222222222222222222221111111111111111133322
row9=222222111222222222211122221111111111111111122221112222222222111222222
row10=222222111222222222211122221111111111111111122221112222222222111222222
row11=222222111222222222211122221111111111111111122221112222222222111222222
row12=222222111222222222211122221112222111222211122221112222222222111222222
row13=222222111222222222211111111112222111222211111111112222222222111222222
row14=222222111222222222211111111112222111222211111111112222222222111222222
row15=222222111222222222211111111112222111222211111111112222222222111222222
row16=222222111222222222222222222222222111222222222222222222222222111222222
row17=222222111222222222222222222222222111222222222222222222222222111222222
row18=222222111222222222222222222222222111222222222222222222222222111222222
row19=222222111111111122222222222222222111222222222222222221111111111222222
row20=222222111111111122221111111111111111111111111111122221111111111222222
row21=222222111111111122221111111111111111111111111111122221111111111222222
row22=222222222222211122221111111111111111111111111111122221112222222222222
row23=222222222222211122221111122222222222222222221111122221112222222222222
row24=222222222222211122221111112222222222222222211111122221112222222222222
row25=222222222222211122221112111222222222222222111211122221112222222222222
row26=222222222111111122221112211122222222222221112211122221111111222222222
row27=222222222111111122221112221333333333333333122211122221111111222222222
row28=222222222111111122221112222333333333333333222211122221111111222222222
row29=222222222111222222221112222333333333333333222211122222222111222222222
row30=222222222111222222221112222333333333333333222211122222222111222222222
row31=222222222111222222221112222333333333333333222211122222222111222222222
row32=222222222111222222221112222333333333333333222211122222222111222222222
row33=222222222111111111111112222333333111333333222211111111111111222222222
row34=222222222111111111111112222333333111333333222211111111111111222222222
row35=222222222111111111111112222333333111333333222211111111111111222222222
row36=222222222111222222221112222333333333333333222211122222222111222222222
row37=222222222111222222221112222333333333333333222211122222222111222222222
row38=222222222111222222221112222333333333333333222211122222222111222222222
row39=222222222111222222221112222333333333333333222211122222222111222222222
row40=222222222111111122221112222333333333333333222211122221111111222222222
row41=222222222111111122221112221333333333333333122211122221111111222222222
row42=222222222111111122221112211122222222222221112211122221111111222222222
row43=222222222222211122221112111222222222222222111211122221112222222222222
row44=222222222222211122221111112222222222222222211111122221112222222222222
row45=222222222222211122221111122222222222222222221111122221112222222222222
row46=222222222222211122221111111111111111111111111111122221112222222222222
row47=222222111111111122221111111111111111111111111111122221111111111222222
row48=222222111111111122221111111111111111111111111111122221111111111222222
row49=222222111111111122222222222222222111222222222222222221111111111222222
row50=222222111222222222222222222222222111222222222222222222222222111222222
row51=222222111222222222222222222222222111222222222222222222222222111222222
row52=222222111222222222222222222222222111222222222222222222222222111222222
row53=222222111222222222211111111112222111222211111111112222222222111222222
row54=222222111222222222211111111112222111222211111111112222222222111222222
row55=222222111222222222211111111112222111222211111111112222222222111222222
row56=222222111222222222211122221112222111222211122221112222222222111222222
row57=222222111222222222211122221111111111111111122221112222222222111222222
row58=222222111222222222211122221111111111111111122221112222222222111222222
row59=222222111222222222211122221111111111111111122221112222222222111222222
row60=223331111111111111111122222222222222222222222221111111111111111133322
row61=223311111111111111111122222222222222222222222221111111111111111113322
row62=223111111111111111111122222222222222222222222221111111111111111111322
row63=221111111222222222222222222222222222222222222222222222222222111111122
row64=221111113222222222222222222222222222222222222222222222222222311111122
row65=221111133222222222222222222222222222222222222222222222222222331111122
row66=221111333222222222222222222222222222222222222222222222222222333111122
row67=222222222222222222222222222222222222222222222222222222222222222222222
row68=222222222222222222222222222222222222222222222222222222222222222222222

[placements]
count=0

[buyables]
count=0

[waypoint0]
count=2
pos0=3x7
pos1=34x34

[waypoint1]
count=2
pos0=65x61
pos1=34x34

[waypoint2]
count=2
pos0=61x3
pos1=34x34

[waypoint3]
count=2
pos0=7x65
pos1=34x34

[waypoint4]
count=2
pos0=7x3
pos1=34x34

[waypoint5]
count=2
pos0=61x65
pos1=34x34

[waypoint6]
count=2
pos0=65x7
pos1=34x34

[waypoint7]
count=2
pos0=3x61
pos1=34x34

[HighScore]
PlayerCats=0
