[map]
size=79x63
description=
background=backtex.jpg
maxplayer=6
lives0=10
lives1=5
lives2=1
type=3
waves=0
dc1=dc1.png
dc2=dc2.png
dc3=dc3.png
dc4=dc4.png

[data]
row0=0000000000000000000000000000000003333111113333000000000000000000000000000000000
row1=0000000000000000000000000000000003333111113333000000000000000000000000000000000
row2=0000000000000000000000000000000003333333333333000000000000000000000000000000000
row3=0000000000000000000000000000000003333333333333000000000000000000000000000000000
row4=0033333333333333333330000000000003333333333333000000000000333333333333333333300
row5=0033333333333333333333000000000033333333333333300000000003333333333333333333300
row6=0033333333333333333333300000000333333333333333330000000033333333333333333333300
row7=0033333333333333333333330000003333333333333333333000000333333333333333333333300
row8=0033333333333333333333333000033333333333333333333300003333333333333333333333300
row9=0033333333333333333333333300333333333333333333333330033333333333333333333333300
row10=0033333333333333333333333333333333333333333333333333333333333333333333333333300
row11=0033333333333333333333333333333333333333333333333333333333333333333333333333300
row12=0033333333333333333333333333333333333333333333333333333333333333333333333333300
row13=0033333333300333333333333333333333333333333333333333333333333333330033333333300
row14=0033333333300033333333333333333333333333333333333333333333333333300033333333300
row15=0033333333300003333333333333333333333330333333333333333333333333000033333333300
row16=0033333333300000333333333333333333333300033333333333333333333330000033333333300
row17=0033333333300000033333333333333333333000003333333333333333333300000033333333300
row18=0033333333300000003333333333333333330000000333333333333333333000000033333333300
row19=0033333333300000000000000000000000000000000000000000000000000000000033333333300
row20=0033333333300000000000000000000000000000000000000000000000000000000033333333300
row21=0033333333300000000000000000000000000000000000000000000000000000000033333333300
row22=0033333333300000000000000000000000000000000000000000000000000000000033333333300
row23=0033333333300000000000000000000000000000000000000000000000000000000033333333300
row24=0033333333300000000000000000000000000000000000000000000000000000000033333333300
row25=0033333333300000000000000000000000000000000000000000000000000000000033333333300
row26=0033333333300000000000000000000000000000000000000000000000000000000033333333300
row27=0033333333333333333333333333333333333333333333333333333333333333333333333333300
row28=0033333333333333333333333333333333333333333333333333333333333333333333333333300
row29=0033333333333333333333333333333333333333333333333333333333333333333333333333300
row30=0033311133333333333333333333333333333333333333333333333333333333333333311133300
row31=0033311133333333333333333333333333333333333333333333333333333333333333311133300
row32=0033311133333333333333333333333333333333333333333333333333333333333333311133300
row33=0033333333333333333333333333333333333333333333333333333333333333333333333333300
row34=0033333333333333333333333333333333333333333333333333333333333333333333333333300
row35=0033333333333333333333333333333333333333333333333333333333333333333333333333300
row36=0033333333300000000000000000000000000000000000000000000000000000000033333333300
row37=0033333333300000000000000000000000000000000000000000000000000000000033333333300
row38=0033333333300000000000000000000000000000000000000000000000000000000033333333300
row39=0033333333300000000000000000000000000000000000000000000000000000000033333333300
row40=0033333333300000000000000000000000000000000000000000000000000000000033333333300
row41=0033333333300000000000000000000000000000000000000000000000000000000033333333300
row42=0033333333300000000000000000000000000000000000000000000000000000000033333333300
row43=0033333333300000000000000000000000000000000000000000000000000000000033333333300
row44=0033333333300000003333333333333333330000000333333333333333333000000033333333300
row45=0033333333300000033333333333333333333000003333333333333333333300000033333333300
row46=0033333333300000333333333333333333333300033333333333333333333330000033333333300
row47=0033333333300003333333333333333333333330333333333333333333333333000033333333300
row48=0033333333300033333333333333333333333333333333333333333333333333300033333333300
row49=0033333333300333333333333333333333333333333333333333333333333333330033333333300
row50=0033333333333333333333333333333333333333333333333333333333333333333333333333300
row51=0033333333333333333333333333333333333333333333333333333333333333333333333333300
row52=0033333333333333333333333333333333333333333333333333333333333333333333333333300
row53=0033333333333333333333333300333333333333333333333330033333333333333333333333300
row54=0033333333333333333333333000033333333333333333333300003333333333333333333333300
row55=0033333333333333333333330000003333333333333333333000000333333333333333333333300
row56=0033333333333333333333300000000333333333333333330000000033333333333333333333300
row57=0033333333333333333333000000000033333333333333300000000003333333333333333333300
row58=0033333333333333333330000000000003333333333333000000000000333333333333333333300
row59=0000000000000000000000000000000003333333333333000000000000000000000000000000000
row60=0000000000000000000000000000000003333333333333000000000000000000000000000000000
row61=0000000000000000000000000000000003333111113333000000000000000000000000000000000
row62=0000000000000000000000000000000003333111113333000000000000000000000000000000000

[placements]
count=0

[buyables]
count=0

[waypoint0]
count=2
pos0=37x1
pos1=37x61

[waypoint1]
count=2
pos0=41x61
pos1=41x1

[waypoint2]
count=2
pos0=6x31
pos1=72x31

[waypoint3]
count=2
pos0=72x31
pos1=6x31

[waypoint4]
count=2
pos0=41x1
pos1=41x61

[waypoint5]
count=2
pos0=37x61
pos1=37x1

[HighScore]
PlayerCats=0
