[map]
size=102x70
description=
background=backtex.jpg
maxplayer=4
lives0=10
lives1=5
lives2=1
type=3
waves=0
dc1=dc1.png
dc2=dc2.png
dc3=dc3.png
dc4=dc4.png

[data]
row0=003333311113333300000000000000333331111333330000000000000033333111133333000000000000003333311113333300
row1=003333311113333300000000000000333331111333330000000000000033333111133333000000000000003333311113333300
row2=003333333333333300000000000000333333333333330000000000000033333333333333000000000000003333333333333300
row3=003333333333333300000000000000333333333333330000000000000033333333333333000000000000003333333333333300
row4=003333333333333300000000000000333333333333330000000000000033333333333333000000000000003333333333333300
row5=003333333333333300000000000000333333333333330000000000000033333333333333000000000000003333333333333300
row6=003333333333333300000000000000333333333333330000000000000033333333333333000000000000003333333333333300
row7=003333333333333300000000000000333333333333330000000000000033333333333333000000000000003333333333333300
row8=003333333333333300000000000000333333333333330000000000000033333333333333000000000000003333333333333300
row9=003333333333333300000000000000333333333333330000000000000033333333333333000000000000003333333333333300
row10=003333333333333300000000000000333333333333330000000000000033333333333333000000000000003333333333333300
row11=003333333333333300000000000000333333333333330000000000000033333333333333000000000000003333333333333300
row12=003333333333333300000000000000333333333333330000000000000033333333333333000000000000003333333333333300
row13=003333333333333300000000000000333333333333330000000000000033333333333333000000000000003333333333333300
row14=003333333333333333333333333333333333333333330000000000000033333333333333333333333333333333333333333300
row15=003333333333333333333333333333333333333333330000000000000033333333333333333333333333333333333333333300
row16=003333333333333333333333333333333333333333330000000000000033333333333333333333333333333333333333333300
row17=003333333333333333333333333333333333333333330000000000000033333333333333333333333333333333333333333300
row18=003333333333333333333333333333333333333333330000000000000033333333333333333333333333333333333333333300
row19=003333333333333333333333333333333333333333330000000000000033333333333333333333333333333333333333333300
row20=003333333333333333333333333333333333333333330000000000000033333333333333333333333333333333333333333300
row21=003333333333333333333333333333333333333333330000000000000033333333333333333333333333333333333333333300
row22=003333333333333333333333333333333333333333330000000000000033333333333333333333333333333333333333333300
row23=003333333333333333333333333333333333333333330000000000000033333333333333333333333333333333333333333300
row24=003333333333333333333333333333333333333333330000000000000033333333333333333333333333333333333333333300
row25=003333333333333333333333333333333333333333330000000000000033333333333333333333333333333333333333333300
row26=003333333333333333333333333333333333333333330000000000000033333333333333333333333333333333333333333300
row27=003333333333333333333333333333333333333333330000000000000033333333333333333333333333333333333333333300
row28=000000000000000033333333333333000000000000000000000000000000000000000000333333333333330000000000000000
row29=000000000000000033333333333333000000000000000000000000000000000000000000333333333333330000000000000000
row30=000000000000000033333333333333000000000000000000000000000000000000000000333333333333330000000000000000
row31=000000000000000033333333333333000000000000000000000000000000000000000000333333333333330000000000000000
row32=000000000000000033333333333333000000000000000000000000000000000000000000333333333333330000000000000000
row33=000000000000000033333333333333000000000000000000000000000000000000000000333333333333330000000000000000
row34=000000000000000033333333333333000000000000000000000000000000000000000000333333333333330000000000000000
row35=000000000000000033333333333333000000000000000000000000000000000000000000333333333333330000000000000000
row36=000000000000000033333333333333000000000000000000000000000000000000000000333333333333330000000000000000
row37=000000000000000033333333333333000000000000000000000000000000000000000000333333333333330000000000000000
row38=000000000000000033333333333333000000000000000000000000000000000000000000333333333333330000000000000000
row39=000000000000000033333333333333000000000000000000000000000000000000000000333333333333330000000000000000
row40=000000000000000033333333333333000000000000000000000000000000000000000000333333333333330000000000000000
row41=000000000000000033333333333333000000000000000000000000000000000000000000333333333333330000000000000000
row42=000000000000000033333333333333333333333333333333333333333333333333333333333333333333330000000000000000
row43=000000000000000033333333333333333333333333333333333333333333333333333333333333333333330000000000000000
row44=000000000000000033333333333333333333333333333333333333333333333333333333333333333333330000000000000000
row45=000000000000000033333333333333333333333333333333333333333333333333333333333333333333330000000000000000
row46=000000000000000033333333333333333333333333333333333333333333333333333333333333333333330000000000000000
row47=000000000000000033333333333333333333333333333333333333333333333333333333333333333333330000000000000000
row48=000000000000000033333333333333333333333333333333333333333333333333333333333333333333330000000000000000
row49=000000000000000033333333333333333333333333333333333333333333333333333333333333333333330000000000000000
row50=000000000000000033333333333333333333333333333333333333333333333333333333333333333333330000000000000000
row51=000000000000000033333333333333333333333333333333333333333333333333333333333333333333330000000000000000
row52=000000000000000033333333333333333333333333333333333333333333333333333333333333333333330000000000000000
row53=000000000000000033333333333333333333333333333333333333333333333333333333333333333333330000000000000000
row54=000000000000000033333333333333333333333333333333333333333333333333333333333333333333330000000000000000
row55=000000000000000033333333333333333333333333333333333333333333333333333333333333333333330000000000000000
row56=000000000000000000000000000000000000000000003333333333333300000000000000000000000000000000000000000000
row57=000000000000000000000000000000000000000000003333333333333300000000000000000000000000000000000000000000
row58=000000000000000000000000000000000000000000003333333333333300000000000000000000000000000000000000000000
row59=000000000000000000000000000000000000000000003333333333333300000000000000000000000000000000000000000000
row60=000000000000000000000000000000000000000000003333333333333300000000000000000000000000000000000000000000
row61=000000000000000000000000000000000000000000003333333333333300000000000000000000000000000000000000000000
row62=000000000000000000000000000000000000000000003333333333333300000000000000000000000000000000000000000000
row63=000000000000000000000000000000000000000000003333333333333300000000000000000000000000000000000000000000
row64=000000000000000000000000000000000000000000003333333333333300000000000000000000000000000000000000000000
row65=000000000000000000000000000000000000000000003333333333333300000000000000000000000000000000000000000000
row66=000000000000000000000000000000000000000000003333333333333300000000000000000000000000000000000000000000
row67=000000000000000000000000000000000000000000003333333333333300000000000000000000000000000000000000000000
row68=000000000000000000000000000000000000000000003333311113333300000000000000000000000000000000000000000000
row69=000000000000000000000000000000000000000000003333311113333300000000000000000000000000000000000000000000

[placements]
count=0

[buyables]
count=0

[waypoint0]
count=2
pos0=8x1
pos1=50x68

[waypoint1]
count=2
pos0=93x1
pos1=51x68

[waypoint2]
count=2
pos0=36x1
pos1=50x68

[waypoint3]
count=2
pos0=65x1
pos1=51x68

[HighScore]
PlayerCats=0
