[map]
size=60x56
description=
background=Background.png
dc1=dc1.png
dc2=dc2.png
dc3=dc3.png
dc4=dc4.png
maxplayer=1
lives0=25
lives1=10
lives2=1
type=0
waves=0

[data]
row0=222222222222222222222222222222222222222222222222222201112222
row1=222222222222222222222222222222222222222222222222222201112222
row2=222222222222222222222222222222222222222222222222220001112222
row3=222222222222222222222222222222222222222222222222220221112222
row4=222211111111111111111111111111111111111111111111100221112222
row5=222211111111111111111111111111111111111111111111122221112222
row6=222211111111111111111111111111111111111111111111122221112222
row7=222211102222222222222222222222222222222222222211122221112222
row8=222211102222222222222222222222222222222222222211122221112222
row9=222211122022222222222222222222222222222222220011122221112222
row10=222211122022222222222222222222222222222222222211122221112222
row11=222211122221111111111111111111111111111111002211122221112222
row12=222211122221111111111111111111111111111111222211122221112222
row13=222211122221111111111111111111111111111111222211122221112222
row14=222211122221112222222222222222222222220111222211122221112222
row15=222211122221112222222222222222222222220111222211122221112222
row16=222211122221112222222222222222222222220111222211122221112222
row17=222211122221112222222222222222222222220111222211122221112222
row18=222211122221112222111111111122222222000111222211122221112222
row19=222211122221112222111111111122222222022111222211122221112222
row20=222211122221112222111111111122221110022111222211122221112222
row21=222211122221112222111222211122221112222111222211122221112222
row22=222211122221112222111222211122221112222111222211122221112222
row23=222211122221112222111222211122221112222111222211122221112222
row24=222211122221112222111222211122221112222111222211122221112222
row25=222211122221112222111222211122221112222111222211122221112222
row26=222211122221112222111222211122221112222111222211122221112222
row27=222211122221112222111222211122221112222111222211122221112222
row28=222211122221112222111222211111111112222111222211122221112222
row29=222211122221112222111222211111111112222111222211122221112222
row30=222211122221112222111222211111111112222111222211122221112222
row31=222211122221112222111222222222222222222111222211122221112222
row32=222211122221112222111222222222222222222111222211122221112222
row33=222211122221112222111222222222222222222111222211122221112222
row34=222211122221112222111222222222222222222111222211122221112222
row35=222211122221112222111111111111111111111111222211122221112222
row36=222211122221112222111111111111111111111111222211122221112222
row37=222211122221112222111111111111111111111111222211122221112222
row38=222211122221112222222222222222222222222222222211122221112222
row39=222211122221112222222222222222222222222222222211122221112222
row40=222211122221112222222222222222222222222222222211122221112222
row41=222211122221112222222222222222222222222222222211122221112222
row42=222211122221111111111111111111111111111111111111122221112222
row43=222211122221111111111111111111111111111111111111122221112222
row44=222211122221111111111111111111111111111111111111122221112222
row45=222211122222222222222222222222222222222222222222222221112222
row46=222211122222222222222222222222222222222222222222222221112222
row47=222211122222222222222222222222222222222222222222222221112222
row48=222211122222222222222222222222222222222222222222222221112222
row49=222211111111111111111111111111111111111111111111111111112222
row50=222211111111111111111111111111111111111111111111111111112222
row51=222211111111111111111111111111111111111111111111111111112222
row52=222222222222222222222222222222222222222222222222222222222222
row53=222222222222222222222222222222222222222222222222222222222222
row54=222222222222222222222222222222222222222222222222222222222222
row55=222222222222222222222222222222222222222222222222222222222222

[waypoint0]
count=16
pos0=33x21
pos1=33x29
pos2=26x29
pos3=26x19
pos4=19x19
pos5=19x36
pos6=40x36
pos7=40x12
pos8=12x12
pos9=12x43
pos10=47x43
pos11=47x5
pos12=5x5
pos13=5x50
pos14=54x50
pos15=54x1

[placements]
count=0

[buyables]
count=0

[HighScore]
PlayerCats=0
Hash=0

[Rating]
Count=0
Sum=0
