[map]
size=125x122
description=
background=backtex.jpg
maxplayer=9
lives0=10
lives1=5
lives2=1
type=2
waves=0
dc1=dc1.png
dc2=dc2.png
dc3=dc3.png
dc4=dc4.png

[data]
row0=00000000000000000000000000000000000000000000000000000000000000000000000000000000000000000000000000000000000000000000000000000
row1=00000000000000000000000000000000000000000000000000000000000000000000000000000000000000000000000000000000000000000000000000000
row2=00333333333333333333333333333333333333333003333333333333333333333333333333333333330033333333333333333333333333333333333333300
row3=00333333333333333333333333333333333333333003333333333333333333333333333333333333330033333333333333333333333333333333333333300
row4=00333333333333333333333333333333333333311003333333333333333333333333333333333333110033333333333333333333333333333333333331100
row5=00333333333333333333333333333333333333311003333333333333333333333333333333333333110033333333333333333333333333333333333331100
row6=00333333333333333333333333333333333333311003333333333333333333333333333333333333110033333333333333333333333333333333333331100
row7=00333333333333333333333333333333333333311003333333333333333333333333333333333333110033333333333333333333333333333333333331100
row8=00333333333333333333333333333333333333333003333333333333333333333333333333333333330033333333333333333333333333333333333333300
row9=00333333333333333333333333333333333333333003333333333333333333333333333333333333330033333333333333333333333333333333333333300
row10=00333333330000000000000000000000000000000003333333300000000000000000000000000000000033333333000000000000000000000000000000000
row11=00333333330000000000000000000000000000000003333333300000000000000000000000000000000033333333000000000000000000000000000000000
row12=00333333330033333333333333333333333333333003333333300333333333333333333333333333330033333333003333333333333333333333333333300
row13=00333333330033333333333333333333333333333003333333300333333333333333333333333333330033333333003333333333333333333333333333300
row14=00333333330033333333333333333333333333333003333333300333333333333333333333333333330033333333003333333333333333333333333333300
row15=00333333330033333333333333333333333333333003333333300333333333333333333333333333330033333333003333333333333333333333333333300
row16=00333333330033333333333333333333333333333003333333300333333333333333333333333333330033333333003333333333333333333333333333300
row17=00333333330033333333333333333333333333333003333333300333333333333333333333333333330033333333003333333333333333333333333333300
row18=00333333330033333333333333333333333333333003333333300333333333333333333333333333330033333333003333333333333333333333333333300
row19=00333333330033333333333333333333333333333003333333300333333333333333333333333333330033333333003333333333333333333333333333300
row20=00333333330033333333000000000000033333333003333333300333333330000000000000333333330033333333003333333300000000000003333333300
row21=00333333330033333333000000000000033333333003333333300333333330000000000000333333330033333333003333333300000000000003333333300
row22=00333333330033333333333333333330033333333003333333300333333333333333333300333333330033333333003333333333333333333003333333300
row23=00333333330033333333333333333330033333333003333333300333333333333333333300333333330033333333003333333333333333333003333333300
row24=00333333330033333333333333333110033333333003333333300333333333333333331100333333330033333333003333333333333333311003333333300
row25=00333333330033333333333333333110033333333003333333300333333333333333331100333333330033333333003333333333333333311003333333300
row26=00333333330033333333333333333110033333333003333333300333333333333333331100333333330033333333003333333333333333311003333333300
row27=00333333330033333333333333333110033333333003333333300333333333333333331100333333330033333333003333333333333333311003333333300
row28=00333333330033333333333333333330033333333003333333300333333333333333333300333333330033333333003333333333333333333003333333300
row29=00333333330033333333333333333330033333333003333333300333333333333333333300333333330033333333003333333333333333333003333333300
row30=00333333330000000000000000000000033333333003333333300000000000000000000000333333330033333333000000000000000000000003333333300
row31=00333333330000000000000000000000033333333003333333300000000000000000000000333333330033333333000000000000000000000003333333300
row32=00333333333333333333333333333333333333333003333333333333333333333333333333333333330033333333333333333333333333333333333333300
row33=00333333333333333333333333333333333333333003333333333333333333333333333333333333330033333333333333333333333333333333333333300
row34=00333333333333333333333333333333333333333003333333333333333333333333333333333333330033333333333333333333333333333333333333300
row35=00333333333333333333333333333333333333333003333333333333333333333333333333333333330033333333333333333333333333333333333333300
row36=00333333333333333333333333333333333333333003333333333333333333333333333333333333330033333333333333333333333333333333333333300
row37=00333333333333333333333333333333333333333003333333333333333333333333333333333333330033333333333333333333333333333333333333300
row38=00333333333333333333333333333333333333333003333333333333333333333333333333333333330033333333333333333333333333333333333333300
row39=00333333333333333333333333333333333333333003333333333333333333333333333333333333330033333333333333333333333333333333333333300
row40=00000000000000000000000000000000000000000000000000000000000000000000000000000000000000000000000000000000000000000000000000000
row41=00000000000000000000000000000000000000000000000000000000000000000000000000000000000000000000000000000000000000000000000000000
row42=00333333333333333333333333333333333333333003333333333333333333333333333333333333330033333333333333333333333333333333333333300
row43=00333333333333333333333333333333333333333003333333333333333333333333333333333333330033333333333333333333333333333333333333300
row44=00333333333333333333333333333333333333311003333333333333333333333333333333333333110033333333333333333333333333333333333331100
row45=00333333333333333333333333333333333333311003333333333333333333333333333333333333110033333333333333333333333333333333333331100
row46=00333333333333333333333333333333333333311003333333333333333333333333333333333333110033333333333333333333333333333333333331100
row47=00333333333333333333333333333333333333311003333333333333333333333333333333333333110033333333333333333333333333333333333331100
row48=00333333333333333333333333333333333333333003333333333333333333333333333333333333330033333333333333333333333333333333333333300
row49=00333333333333333333333333333333333333333003333333333333333333333333333333333333330033333333333333333333333333333333333333300
row50=00333333330000000000000000000000000000000003333333300000000000000000000000000000000033333333000000000000000000000000000000000
row51=00333333330000000000000000000000000000000003333333300000000000000000000000000000000033333333000000000000000000000000000000000
row52=00333333330033333333333333333333333333333003333333300333333333333333333333333333330033333333003333333333333333333333333333300
row53=00333333330033333333333333333333333333333003333333300333333333333333333333333333330033333333003333333333333333333333333333300
row54=00333333330033333333333333333333333333333003333333300333333333333333333333333333330033333333003333333333333333333333333333300
row55=00333333330033333333333333333333333333333003333333300333333333333333333333333333330033333333003333333333333333333333333333300
row56=00333333330033333333333333333333333333333003333333300333333333333333333333333333330033333333003333333333333333333333333333300
row57=00333333330033333333333333333333333333333003333333300333333333333333333333333333330033333333003333333333333333333333333333300
row58=00333333330033333333333333333333333333333003333333300333333333333333333333333333330033333333003333333333333333333333333333300
row59=00333333330033333333333333333333333333333003333333300333333333333333333333333333330033333333003333333333333333333333333333300
row60=00333333330033333333000000000000033333333003333333300333333330000000000000333333330033333333003333333300000000000003333333300
row61=00333333330033333333000000000000033333333003333333300333333330000000000000333333330033333333003333333300000000000003333333300
row62=00333333330033333333333333333330033333333003333333300333333333333333333300333333330033333333003333333333333333333003333333300
row63=00333333330033333333333333333330033333333003333333300333333333333333333300333333330033333333003333333333333333333003333333300
row64=00333333330033333333333333333110033333333003333333300333333333333333331100333333330033333333003333333333333333311003333333300
row65=00333333330033333333333333333110033333333003333333300333333333333333331100333333330033333333003333333333333333311003333333300
row66=00333333330033333333333333333110033333333003333333300333333333333333331100333333330033333333003333333333333333311003333333300
row67=00333333330033333333333333333110033333333003333333300333333333333333331100333333330033333333003333333333333333311003333333300
row68=00333333330033333333333333333330033333333003333333300333333333333333333300333333330033333333003333333333333333333003333333300
row69=00333333330033333333333333333330033333333003333333300333333333333333333300333333330033333333003333333333333333333003333333300
row70=00333333330000000000000000000000033333333003333333300000000000000000000000333333330033333333000000000000000000000003333333300
row71=00333333330000000000000000000000033333333003333333300000000000000000000000333333330033333333000000000000000000000003333333300
row72=00333333333333333333333333333333333333333003333333333333333333333333333333333333330033333333333333333333333333333333333333300
row73=00333333333333333333333333333333333333333003333333333333333333333333333333333333330033333333333333333333333333333333333333300
row74=00333333333333333333333333333333333333333003333333333333333333333333333333333333330033333333333333333333333333333333333333300
row75=00333333333333333333333333333333333333333003333333333333333333333333333333333333330033333333333333333333333333333333333333300
row76=00333333333333333333333333333333333333333003333333333333333333333333333333333333330033333333333333333333333333333333333333300
row77=00333333333333333333333333333333333333333003333333333333333333333333333333333333330033333333333333333333333333333333333333300
row78=00333333333333333333333333333333333333333003333333333333333333333333333333333333330033333333333333333333333333333333333333300
row79=00333333333333333333333333333333333333333003333333333333333333333333333333333333330033333333333333333333333333333333333333300
row80=00000000000000000000000000000000000000000000000000000000000000000000000000000000000000000000000000000000000000000000000000000
row81=00000000000000000000000000000000000000000000000000000000000000000000000000000000000000000000000000000000000000000000000000000
row82=00333333333333333333333333333333333333333003333333333333333333333333333333333333330033333333333333333333333333333333333333300
row83=00333333333333333333333333333333333333333003333333333333333333333333333333333333330033333333333333333333333333333333333333300
row84=00333333333333333333333333333333333333311003333333333333333333333333333333333333110033333333333333333333333333333333333331100
row85=00333333333333333333333333333333333333311003333333333333333333333333333333333333110033333333333333333333333333333333333331100
row86=00333333333333333333333333333333333333311003333333333333333333333333333333333333110033333333333333333333333333333333333331100
row87=00333333333333333333333333333333333333311003333333333333333333333333333333333333110033333333333333333333333333333333333331100
row88=00333333333333333333333333333333333333333003333333333333333333333333333333333333330033333333333333333333333333333333333333300
row89=00333333333333333333333333333333333333333003333333333333333333333333333333333333330033333333333333333333333333333333333333300
row90=00333333330000000000000000000000000000000003333333300000000000000000000000000000000033333333000000000000000000000000000000000
row91=00333333330000000000000000000000000000000003333333300000000000000000000000000000000033333333000000000000000000000000000000000
row92=00333333330033333333333333333333333333333003333333300333333333333333333333333333330033333333003333333333333333333333333333300
row93=00333333330033333333333333333333333333333003333333300333333333333333333333333333330033333333003333333333333333333333333333300
row94=00333333330033333333333333333333333333333003333333300333333333333333333333333333330033333333003333333333333333333333333333300
row95=00333333330033333333333333333333333333333003333333300333333333333333333333333333330033333333003333333333333333333333333333300
row96=00333333330033333333333333333333333333333003333333300333333333333333333333333333330033333333003333333333333333333333333333300
row97=00333333330033333333333333333333333333333003333333300333333333333333333333333333330033333333003333333333333333333333333333300
row98=00333333330033333333333333333333333333333003333333300333333333333333333333333333330033333333003333333333333333333333333333300
row99=00333333330033333333333333333333333333333003333333300333333333333333333333333333330033333333003333333333333333333333333333300
row100=00333333330033333333000000000000033333333003333333300333333330000000000000333333330033333333003333333300000000000003333333300
row101=00333333330033333333000000000000033333333003333333300333333330000000000000333333330033333333003333333300000000000003333333300
row102=00333333330033333333333333333330033333333003333333300333333333333333333300333333330033333333003333333333333333333003333333300
row103=00333333330033333333333333333330033333333003333333300333333333333333333300333333330033333333003333333333333333333003333333300
row104=00333333330033333333333333333110033333333003333333300333333333333333331100333333330033333333003333333333333333311003333333300
row105=00333333330033333333333333333110033333333003333333300333333333333333331100333333330033333333003333333333333333311003333333300
row106=00333333330033333333333333333110033333333003333333300333333333333333331100333333330033333333003333333333333333311003333333300
row107=00333333330033333333333333333110033333333003333333300333333333333333331100333333330033333333003333333333333333311003333333300
row108=00333333330033333333333333333330033333333003333333300333333333333333333300333333330033333333003333333333333333333003333333300
row109=00333333330033333333333333333330033333333003333333300333333333333333333300333333330033333333003333333333333333333003333333300
row110=00333333330000000000000000000000033333333003333333300000000000000000000000333333330033333333000000000000000000000003333333300
row111=00333333330000000000000000000000033333333003333333300000000000000000000000333333330033333333000000000000000000000003333333300
row112=00333333333333333333333333333333333333333003333333333333333333333333333333333333330033333333333333333333333333333333333333300
row113=00333333333333333333333333333333333333333003333333333333333333333333333333333333330033333333333333333333333333333333333333300
row114=00333333333333333333333333333333333333333003333333333333333333333333333333333333330033333333333333333333333333333333333333300
row115=00333333333333333333333333333333333333333003333333333333333333333333333333333333330033333333333333333333333333333333333333300
row116=00333333333333333333333333333333333333333003333333333333333333333333333333333333330033333333333333333333333333333333333333300
row117=00333333333333333333333333333333333333333003333333333333333333333333333333333333330033333333333333333333333333333333333333300
row118=00333333333333333333333333333333333333333003333333333333333333333333333333333333330033333333333333333333333333333333333333300
row119=00333333333333333333333333333333333333333003333333333333333333333333333333333333330033333333333333333333333333333333333333300
row120=00000000000000000000000000000000000000000000000000000000000000000000000000000000000000000000000000000000000000000000000000000
row121=00000000000000000000000000000000000000000000000000000000000000000000000000000000000000000000000000000000000000000000000000000

[placements]
count=0

[buyables]
count=0

[waypoint0]
count=2
pos0=39x5
pos1=29x26

[waypoint1]
count=2
pos0=80x5
pos1=70x26

[waypoint2]
count=2
pos0=121x5
pos1=111x26

[waypoint3]
count=2
pos0=39x45
pos1=29x66

[waypoint4]
count=2
pos0=80x45
pos1=70x66

[waypoint5]
count=2
pos0=121x45
pos1=111x66

[waypoint6]
count=2
pos0=39x85
pos1=29x106

[waypoint7]
count=2
pos0=80x85
pos1=70x106

[waypoint8]
count=2
pos0=121x85
pos1=111x106

[HighScore]
PlayerCats=0
