[map]
size=50x50
description=
background=backtex.jpg
maxplayer=2
lives0=10
lives1=5
lives2=1
type=1
waves=0
dc1=dc1.png
dc2=dc2.png
dc3=dc3.png
dc4=dc4.png

[data]
row0=22222222222222222222222222222222222222222222222222
row1=22222222222222222222222222222222222222222222222222
row2=11111111111111111111111111111122222222222222222222
row3=11111111111111111111111111111111112222222222222222
row4=11111111111111111111111111111111111122222222222222
row5=22222222222222222222222222222221111112222222222222
row6=22222222222222222222222222222222211111122222222222
row7=22222222222222222222222222222222222111112222222222
row8=22222222222222222222222222222222222211111222222222
row9=22222222222222222222222222222222222222111122222222
row10=22222222222222222222222222222222222222211122222222
row11=11111111111111111111111111222222222222211112222222
row12=11111111111111111111111111111222222222221111222222
row13=11111111111111111111111111111122222222222111222222
row14=22222222222222222222222222211111222222222111122222
row15=22222222222222222222222222221111122222222211122222
row16=22222222111122222222222222222111112222222211122222
row17=22222211111111222222222222222221112222222211112222
row18=22222111111111122222222222222221111222222221112222
row19=22222111122111122222222222222222111122222221112222
row20=22221111222211112222222222222222211122222221112222
row21=22221112222221112222222222222222211112222221112222
row22=22221112222221112222222222222222221112222221112222
row23=22221112222221112222222222222222221112222221112222
row24=22221112222221112222222222222222221112222221112222
row25=22221112222221112222222222222222221112222221112222
row26=22221112222221112222222222222222221112222221112222
row27=22221112222221112222222222222222221112222221112222
row28=22221112222221111222222222222222221112222221112222
row29=22221112222222111222222222222222221111222211112222
row30=22221112222222111122222222222222222111122111122222
row31=22221112222222211112222222222222222111111111122222
row32=22221111222222221112222222222222222211111111222222
row33=22222111222222221111122222222222222222111122222222
row34=22222111222222222111112222222222222222222222222222
row35=22222111122222222211111222222222222222222222222222
row36=22222211122222222222111111111111111111111111111111
row37=22222211112222222222211111111111111111111111111111
row38=22222221111222222222222211111111111111111111111111
row39=22222222111222222222222222222222222222222222222222
row40=22222222111122222222222222222222222222222222222222
row41=22222222211111222222222222222222222222222222222222
row42=22222222221111122222222222222222222222222222222222
row43=22222222222111111222222222222222222222222222222222
row44=22222222222221111112222222222222222222222222222222
row45=22222222222222111111111111111111111111111111111111
row46=22222222222222221111111111111111111111111111111111
row47=22222222222222222222111111111111111111111111111111
row48=22222222222222222222222222222222222222222222222222
row49=22222222222222222222222222222222222222222222222222

[placements]
count=0

[buyables]
count=0

[waypoint0]
count=3
pos0=0x3
pos1=40x32
pos2=0x12

[waypoint1]
count=3
pos0=49x46
pos1=9x17
pos2=49x37

[HighScore]
PlayerCats=0
