[map]
size=75x75
description=
background=IceMaze.jpg
dc1=dc1.png
dc2=dc2.png
dc3=dc3.png
dc4=dc4.png
maxplayer=8
lives0=0
lives1=0
lives2=0
type=3
waves=0

[data]
row0=000000000000000000000000000000000000000000000000000000000000000000000000000
row1=033303333333330333333333333330333333333333333333333333303333333333333303330
row2=033303333333330333333333333330333333333333333333333333303333333333333303330
row3=033303333333330333333333333330333333333333333333333333303333333333333303330
row4=033303333333330333330000033330000000000033333000000000003333000000333303330
row5=033333333033330333333333033333333303333333333033333333303333333330333303330
row6=033333333033330333333333033333333303333333333033333333303333333330333303330
row7=033333333033330333333333033333333303333333333033333333303333333330333303330
row8=033333333033330333333333033333333303333333333033333333303333333330333303330
row9=033300000033330000003333000000333303333300000033330333300000333330333303330
row10=033303333333333333333333033330333303333333333333330333333333333330333333330
row11=033303333333333333333333033330333303333333333333330333333333333330333333330
row12=033303333333333333333333033330333303333333333333330333333333333330333333330
row13=033303333333333333333333033330333303333333333333330333333333333330333333330
row14=033303333300000000000000033330333303333300000000000000000000000000000000000
row15=033303333333330333333333333330333303333303333333333333333333333333333333330
row16=033303333333330333333333333333333303333303333333333333333333333333333333330
row17=033303333333330333333333333333333303333303333333333333333333333333333333330
row18=033303333333330333333333333333333303333303333333333333333333333333333333330
row19=033300000033330333300000000000333303333300000333330000000000000000000003330
row20=033333333033330333303333333333333303333333333333333333333333033333333303330
row21=033333333033330333303333333333333303333333333333333333333333033333333303330
row22=033333333033330333303333333333333303333333333333333333333333033333333303330
row23=033333333033330333303333333333333303333333333333333333333333033333333303330
row24=000000000033330333303333000000000003333300000000000000000000033333333303330
row25=033333333333330333303333033333333333333333333333330333333333333330333333330
row26=033333333333330333303333033333333333333333333333330333333333333330333333330
row27=033333333333330333303333033333333333333333333333330333333333333330333333330
row28=033333333333330333303333033333333333333333333333330333333333333330333333330
row29=000003333000000000003333033333333333333333333333330333300000000000000003330
row30=033333333033330333333333033333333333333333333333330333303333333333333303330
row31=033333333033330333333333033333333333333333333333330333303333333333333303330
row32=033333333033330333333333033333333333333333333333330333303333333333333303330
row33=033333333033330333333333033333333333333333333333330333303333333333333303330
row34=033330000033330333330000033333333333333333333333330333303333333333333300000
row35=033333333033333333333333033333333333333333333333330333333333033330333333330
row36=033333333033333333333333033333333333333333333333330333333333033330333333330
row37=033333333033333333333333033333333333333333333333330333333333033330333333330
row38=033333333033333333333333033333333333333333333333330333333333033330333333330
row39=033333333033333333333333033333333333333333333333330333333333033330333333330
row40=033303333000000000003333033333333333333333333333330000000000000000000033330
row41=033303333333333333303333033333333333333333333333330333333333333333333333330
row42=033303333333333333303333033333333333333333333333330333333333333333333333330
row43=033303333333333333303333033333333333333333333333330333333333333333333333330
row44=033303333333333333303333033333333333333333333333330333333333333333333333330
row45=033300000000000000003333033333333333333333333333330333303333000000000000000
row46=033333333333333333303333033333333333333333333333330333303333033333333333330
row47=033333333333333333303333033333333333333333333333330333303333033333333333330
row48=033333333333333333303333033333333333333333333333330333303333033333333333330
row49=033333333333333333303333033333333333333333333333330333303333033333333333330
row50=033300000000000333300000000000000000000000000000000333303333033330000033330
row51=033303333033333333303333333330333333333303333333330333303333033330333333330
row52=033303333033333333303333333330333333333303333333330333303333033330333333330
row53=033303333033333333303333333330333333333303333333330333303333033330333333330
row54=033303333033333333303333033330333333333303333333330333303333033330333333330
row55=033303333333333000003333033330000003333303333033330333300000033330333300000
row56=033303333333333333333333033333333333333303333033330333333333333330333333330
row57=033303333333333333333333033333333333333303333033330333333333333330333333330
row58=033303333333333333333333033333333333333303333033330333333333333330333333330
row59=033303333333333333333333033333333333333303333033330333333333333330333333330
row60=033300000000000000000000000000000000000003000000000000000000033330000003330
row61=033333333333333333333333333333333303333333333333333333333333033333333303330
row62=033333333333333333333333333333333303333333333333333333333333033333333303330
row63=033333333333333333333333333333333303333333333333333333333333033333333303330
row64=033333333333333333333333333333333303333333333333333333333333033333333303330
row65=000000000000000000003333300000333333333300000333330333300000000003333303330
row66=033333333333333333333333333330333333333303333333330333333333033333333303330
row67=033333333333333333333333333330333333333303333333330333333333033333333303330
row68=033333333333333333333333333330333333333303333333330333333333033333333303330
row69=033333333333333333333333333330333333333303333333330333333333033333333303330
row70=033330000033333000000000000000000000000000000000000333303333333330000003330
row71=033333333033333333333333333333333303333333333333333333303333333330333333330
row72=033333333033333333333333333333333303333333333333333333303333333330333333330
row73=033333333033333333333333333333333303333333333333333333303333333330333333330
row74=000000000000000000000000000000000000000000000000000000000000000000000000000

[waypoint0]
count=2
pos0=22x47
pos1=37x36

[waypoint1]
count=2
pos0=17x27
pos1=37x36

[waypoint2]
count=2
pos0=7x22
pos1=37x36

[waypoint3]
count=2
pos0=32x52
pos1=37x36

[waypoint4]
count=2
pos0=8x72
pos1=37x37

[waypoint5]
count=2
pos0=37x73
pos1=37x36

[waypoint6]
count=2
pos0=67x72
pos1=37x36

[waypoint7]
count=2
pos0=72x2
pos1=37x36

[placements]
count=0

[buyables]
count=0

[HighScore]
PlayerCats=0
Hash=0

[Rating]
Count=0
Sum=0
