[map]
size=70x70
description=
background=Doungen.JPG
dc1=dc1.png
dc2=dc2.png
dc3=dc3.png
dc4=dc4.png
maxplayer=9
lives0=0
lives1=0
lives2=0
type=3
waves=0

[data]
row0=0000000000000000000000000000000000000000000000000000000000000000000000
row1=0000000000000000000000000000000000000000000000000000000000000000000000
row2=0000000000000000000000000000022200000033333300222222000000000000000000
row3=0000000000000000000000000002222222000033333300222222000000000000000000
row4=0000000000000000000000000002222222200033333300222222003333333333333300
row5=0000000000000000000000000022222222220033333300222222003333333333333300
row6=0000000000000000000000000022222222222233333300222222223333333333333300
row7=0000000000000000000000000022222222222233333300222222223333333333333300
row8=0000000000000000000000000022222222220033333300000000003333333333333300
row9=0000000000000000000000000002222222220033333300000000003333333333333300
row10=0033333333333333330000000002222222200033333300000000000000000033333300
row11=0033333333333333330000000000022222000033333300000000000000000033333300
row12=0033333333333333330000000000000000000033333333333333333333333333333300
row13=0033333333333333330000000000000000000033333333333333333333333333333300
row14=0033333333333333333333333333002222222233333333333333333333333333333300
row15=0033333333333333333333333333002222222233333333333333333333333333333300
row16=0033333300003333333333333333222222220033333333333333333333333333333300
row17=0033333300003333333333333333222222220033333333333333333333333333333300
row18=0033333300003333333333333333002222220000003333330000000000000033333300
row19=0033333300003333333333333333002222220000003333330000000000000033333300
row20=0033333300000000003333330000000000220000003333330000000000000033333300
row21=0033333300000000003333330000000000220000003333330000000000000033333300
row22=0033333300000000003333330000000033333300003333330000000000000033333300
row23=0033333300000000003333330000000033333300003333330000000000000033333300
row24=0033333300000000003333330000000033333300003333330000000000000033333300
row25=0033333300000000003333330000000033333300003333330000000000000033333300
row26=0033333300222222003333333333333333333333333333330022222200000033333300
row27=0033333300222222003333333333333333333333333333330022222200000033333300
row28=0033333300222222003333333333333333333333333333332222222200000033333300
row29=0033333300222222003333333333333333333333333333332222222200000033333300
row30=0033333322222222003333333333333333333333333333330022222200000033333300
row31=0033333322222222003333333333333333333333333333330022222200000033333300
row32=0033333300222222003333330000000000000000003333330022000000000033333300
row33=0033333300222222003333330000000000000000003333330022000000000033333300
row34=0000000000222222223333330000033333333000003333330022333333333333333300
row35=0000000000222222223333330000333333333300003333330033333333333333333300
row36=0000000000000000003333330003333333333330003333330033333333333333333300
row37=0000000000000000003333330003333333333333003333330033333333333333333300
row38=0022222200000000003333330033333333333333003333330033333333333333333300
row39=0022222200000000003333330033333333333333003333330033333333333333333300
row40=0022222200000000003333333333333333333333333333330000000000000033333300
row41=0022222200000000003333333333333333333333333333330000000000000033333300
row42=0022222222333333333333330033333333333333003333330000003333330033333300
row43=0022222222333333333333330033333333333333003333330000003333330033333300
row44=0000000000333333333333330003333333333330003333330000003333330033333300
row45=0000000000333333333333330000333333333300003333330000003333330033333300
row46=0000000000333333333333330000333333333300003333330000003333330033333300
row47=0000000000333333333333330000003333330000003333330000003333330033333300
row48=0000000000333333000000000000002200000000003333330000003333330033333300
row49=0000000000333333000000000000002200000000003333330000003333330033333300
row50=0000000000333333000000000022222200333333333333333333003333330033333300
row51=0000000000333333000000000022222200333333333333333333003333330033333300
row52=0000000000333333000000000022222200333333333333333333333333333333333300
row53=0000000000333333000000000022222200333333333333333333333333333333333300
row54=0000000000333333000000000022222222333333333333333333333333333333333300
row55=0000000000333333000000000022222222333333333333333333333333333333333300
row56=0033333333333333000000000022222200333333000000333333333333333333333300
row57=0033333333333333000000000022222200333333000000333333333333333333333300
row58=0033333333333333000000000022222200333333000000000000002200000033333300
row59=0033333333333333000000000022222200333333000000000000002200000033333300
row60=0033333333333333000000000000220000333333000000222222222222220033333300
row61=0033333333333333000000000000220000333333000000222222222222220033333300
row62=0000000000333333333333333333333333333333000000222222222222220033333300
row63=0000000000333333333333333333333333333333000000222222222222220033333300
row64=0000000000333333333333333333333333333333000000222222222222220000000000
row65=0000000000333333333333333333333333333333000000222222222222220000000000
row66=0000000000333333333333333333333333333333000000000000000000000000000000
row67=0000000000333333333333333333333333333333000000000000000000000000000000
row68=0000000000000000000000000000000000000000000000000000000000000000000000
row69=0000000000000000000000000000000000000000000000000000000000000000000000

[waypoint0]
count=2
pos0=40x4
pos1=32x41

[waypoint1]
count=2
pos0=4x32
pos1=32x41

[waypoint2]
count=2
pos0=64x62
pos1=32x41

[waypoint3]
count=2
pos0=51x37
pos1=32x41

[waypoint4]
count=2
pos0=56x5
pos1=32x41

[waypoint5]
count=2
pos0=3x59
pos1=32x41

[waypoint6]
count=2
pos0=56x44
pos1=32x41

[waypoint7]
count=2
pos0=25x17
pos1=32x41

[waypoint8]
count=2
pos0=34x23
pos1=32x41

[placements]
count=0

[buyables]
count=0

[HighScore]
PlayerCats=0
Hash=0

[Rating]
Count=0
Sum=0
