[map]
size=79x85
description=
background=backtex.jpg
maxplayer=7
lives0=10
lives1=5
lives2=1
type=2
waves=0
dc1=dc1.png
dc2=dc2.png
dc3=dc3.png
dc4=dc4.png

[data]
row0=0000000000000000000000000000000000000000000000000000000000000000000000000000000
row1=0000000000000000000000000000000000000000000000000000000000000000000000000000000
row2=3333333333333333333333333333333333333333333333333333333333333333333333333333333
row3=3333333333333333333333333333333333333333333333333333333333333333333333333333333
row4=1133333333333333333333333333333333333333333333333333333333333333333333333333311
row5=1133333333333333333333333333333333333333333333333333333333333333333333333333311
row6=1133333333333333333333333333333333333333333333333333333333333333333333333333311
row7=1133333333333333333333333333333333333333333333333333333333333333333333333333311
row8=1133333333333333333333333333333333333333333333333333333333333333333333333333311
row9=3333333333333333333333333333333333333333333333333333333333333333333333333333333
row10=3333333333333333333333333333333333333333333333333333333333333333333333333333333
row11=0000000000000000000000000000000000000000000000000000000000000000000000000000000
row12=0000000000000000000000000000000000000000000000000000000000000000000000000000000
row13=0000000000000000000000000000000000000000000000000000000000000000000000000000000
row14=3333333333333333333333333333333333333333333333333333333333333333333333333333333
row15=3333333333333333333333333333333333333333333333333333333333333333333333333333333
row16=1133333333333333333333333333333333333333333333333333333333333333333333333333311
row17=1133333333333333333333333333333333333333333333333333333333333333333333333333311
row18=1133333333333333333333333333333333333333333333333333333333333333333333333333311
row19=1133333333333333333333333333333333333333333333333333333333333333333333333333311
row20=1133333333333333333333333333333333333333333333333333333333333333333333333333311
row21=3333333333333333333333333333333333333333333333333333333333333333333333333333333
row22=3333333333333333333333333333333333333333333333333333333333333333333333333333333
row23=0000000000000000000000000000000000000000000000000000000000000000000000000000000
row24=0000000000000000000000000000000000000000000000000000000000000000000000000000000
row25=0000000000000000000000000000000000000000000000000000000000000000000000000000000
row26=3333333333333333333333333333333333333333333333333333333333333333333333333333333
row27=3333333333333333333333333333333333333333333333333333333333333333333333333333333
row28=1133333333333333333333333333333333333333333333333333333333333333333333333333311
row29=1133333333333333333333333333333333333333333333333333333333333333333333333333311
row30=1133333333333333333333333333333333333333333333333333333333333333333333333333311
row31=1133333333333333333333333333333333333333333333333333333333333333333333333333311
row32=1133333333333333333333333333333333333333333333333333333333333333333333333333311
row33=3333333333333333333333333333333333333333333333333333333333333333333333333333333
row34=3333333333333333333333333333333333333333333333333333333333333333333333333333333
row35=0000000000000000000000000000000000000000000000000000000000000000000000000000000
row36=0000000000000000000000000000000000000000000000000000000000000000000000000000000
row37=0000000000000000000000000000000000000000000000000000000000000000000000000000000
row38=3333333333333333333333333333333333333333333333333333333333333333333333333333333
row39=3333333333333333333333333333333333333333333333333333333333333333333333333333333
row40=1133333333333333333333333333333333333333333333333333333333333333333333333333311
row41=1133333333333333333333333333333333333333333333333333333333333333333333333333311
row42=1133333333333333333333333333333333333333333333333333333333333333333333333333311
row43=1133333333333333333333333333333333333333333333333333333333333333333333333333311
row44=1133333333333333333333333333333333333333333333333333333333333333333333333333311
row45=3333333333333333333333333333333333333333333333333333333333333333333333333333333
row46=3333333333333333333333333333333333333333333333333333333333333333333333333333333
row47=0000000000000000000000000000000000000000000000000000000000000000000000000000000
row48=0000000000000000000000000000000000000000000000000000000000000000000000000000000
row49=0000000000000000000000000000000000000000000000000000000000000000000000000000000
row50=3333333333333333333333333333333333333333333333333333333333333333333333333333333
row51=3333333333333333333333333333333333333333333333333333333333333333333333333333333
row52=1133333333333333333333333333333333333333333333333333333333333333333333333333311
row53=1133333333333333333333333333333333333333333333333333333333333333333333333333311
row54=1133333333333333333333333333333333333333333333333333333333333333333333333333311
row55=1133333333333333333333333333333333333333333333333333333333333333333333333333311
row56=1133333333333333333333333333333333333333333333333333333333333333333333333333311
row57=3333333333333333333333333333333333333333333333333333333333333333333333333333333
row58=3333333333333333333333333333333333333333333333333333333333333333333333333333333
row59=0000000000000000000000000000000000000000000000000000000000000000000000000000000
row60=0000000000000000000000000000000000000000000000000000000000000000000000000000000
row61=0000000000000000000000000000000000000000000000000000000000000000000000000000000
row62=3333333333333333333333333333333333333333333333333333333333333333333333333333333
row63=3333333333333333333333333333333333333333333333333333333333333333333333333333333
row64=1133333333333333333333333333333333333333333333333333333333333333333333333333311
row65=1133333333333333333333333333333333333333333333333333333333333333333333333333311
row66=1133333333333333333333333333333333333333333333333333333333333333333333333333311
row67=1133333333333333333333333333333333333333333333333333333333333333333333333333311
row68=1133333333333333333333333333333333333333333333333333333333333333333333333333311
row69=3333333333333333333333333333333333333333333333333333333333333333333333333333333
row70=3333333333333333333333333333333333333333333333333333333333333333333333333333333
row71=0000000000000000000000000000000000000000000000000000000000000000000000000000000
row72=0000000000000000000000000000000000000000000000000000000000000000000000000000000
row73=0000000000000000000000000000000000000000000000000000000000000000000000000000000
row74=3333333333333333333333333333333333333333333333333333333333333333333333333333333
row75=3333333333333333333333333333333333333333333333333333333333333333333333333333333
row76=1133333333333333333333333333333333333333333333333333333333333333333333333333311
row77=1133333333333333333333333333333333333333333333333333333333333333333333333333311
row78=1133333333333333333333333333333333333333333333333333333333333333333333333333311
row79=1133333333333333333333333333333333333333333333333333333333333333333333333333311
row80=1133333333333333333333333333333333333333333333333333333333333333333333333333311
row81=3333333333333333333333333333333333333333333333333333333333333333333333333333333
row82=3333333333333333333333333333333333333333333333333333333333333333333333333333333
row83=0000000000000000000000000000000000000000000000000000000000000000000000000000000
row84=0000000000000000000000000000000000000000000000000000000000000000000000000000000

[placements]
count=0

[buyables]
count=0

[waypoint0]
count=2
pos0=0x6
pos1=78x6

[waypoint1]
count=2
pos0=78x18
pos1=0x18

[waypoint2]
count=2
pos0=0x30
pos1=78x30

[waypoint3]
count=2
pos0=78x42
pos1=0x42

[waypoint4]
count=2
pos0=0x54
pos1=78x54

[waypoint5]
count=2
pos0=78x66
pos1=0x66

[waypoint6]
count=2
pos0=0x78
pos1=78x78

[HighScore]
PlayerCats=0
